weenxdxum	w ee nx dx u m 
kuurxappadxugirxadeu	k uu rx a p p a dx u g i rx a d eu 
taanxdxi	t aa nx dx i 
innum	i n n u m 
miideu	m ii d eu 
awardaan	a w a r d aa n 
adxaindda	a dx ai nd d a 
parawaa	p a r a w aa 
kuuppidxawaa	k uu p p i dx a w aa 
wa	w a 
la	l a
reesla	r ee s l a 
etxtxeukkaali	e tx tx eu k k aa l i 
seyalgalxaik	s e y a l g a lx ai k 
pirayoojanamaanawai	p i r a y oo j a n a m aa n a w ai 
piriliminari	p i r i l i m i n a r i 
puyalaaga	p u y a l aa g a 
tuukkitxtxeu	t uu k k i tx tx eu 
un	u n 
weenla	w ee n l a 
ezhuppeu	e zh u p p eu 
porxumaiyai	p o rx u m ai y ai 
koodxi	k oo dx i 
kodxeukkappatxtxulxlxa	k o dx eu k k a p p a tx tx u lx lx a 
anjjeu	a nj j eu 
rais	r ai s 
ons	o n s 
waruween	w a r u w ee n 
doosai	d oo s ai 
inxai	i nx ai 
kalagam	k a l a g a m 
adai	a d ai 
tozhil	t o zh i l 
titxtxattil	t i tx tx a t t i l 
maanxawar	m aa nx a w a r 
manaiwi	m a n ai w i 
idoodxa	i d oo dx a 
kaanxbadeu	k aa nx b a d eu 
senggai	s e ng g ai 
jalam	j a l a m 
widxuwadeu	w i dx u w a d eu 
seerxeu	s ee rx eu 
awagaasam	a w a g aa s a m 
waittireukka	w ai t t i r eu k k a 
piradamar	p i r a d a m a r 
wanddulxlxadeu	w a nd d u lx lx a d eu 
aaga	aa g a 
suuzhndilai	s uu zh nd i l ai 
idaiwidxa	i d ai w i dx a 
ndadxakkum	nd a dx a k k u m 
keepsxan	k ee p sx a n 
wijay	w i j a y 
wazhakkeu	w a zh a k k eu 
ndadxitteuk	nd a dx i t t eu k 
ainddeu	ai nd d eu 
ndidi	nd i d i 
maatxrxeu	m aa tx rx eu 
sutxrxulaap	s u tx rx u l aa p 
nduudxuls	nd uu dx u l s 
eppa	e p p a 
waaya	w aa y a 
jipe	j i p e 
konjja	k o nj j a 
ndacceup	nd a c c eu p 
sendndiir	s e nd nd ii r 
udawaadeu	u d a w aa d eu 
appadawiyil	a p p a d a w i y i l 
ulxlxadaagak	u lx lx a d aa g a k 
malyutta	m a l y u t t a 
edxeukkum	e dx eu k k u m 
ireukkirxadee	i r eu k k i rx a d ee 
katxrxeukkolxlxappatxtxulxlxana	k a tx rx eu k k o lx lx a p p a tx tx u lx lx a n a 
padxam	p a dx a m 
tanxnxi	t a nx nx i 
waraada	w a r aa d a 
ungga	u ng g a 
unxaweukkeu	u nx a w eu k k eu 
tiidum	t ii d u m 
unggalx	u ng g a lx 
arxiwuraigalxai	a rx i w u r ai g a lx ai 
tanggattin	t a ng g a t t i n 
awalxudxaiya	a w a lx u dx ai y a 
purigirxadeu	p u r i g i rx a d eu 
ndigazhcciyaiyum	nd i g a zh c c i y ai y u m 
maatxrxikkolxlxudal	m aa tx rx i k k o lx lx u d a l 
paas	p aa s 
kootxtxai	k oo tx tx ai 
azhageu	a zh a g eu 
tatxtxaamee	t a tx tx aa m ee 
adeu	a d eu 
muutta	m uu t t a 
tozhilaalxar	t o zh i l aa lx a r 
ndadxaipetxrxadeu	nd a dx ai p e tx rx a d eu 
urxpatti	u rx p a t t i 
waruwadil	w a r u w a d i l 
oruttaneukkum	o r u t t a n eu k k u m 
amaidi	a m ai d i 
waanggitxtxeen	w aa ng g i tx tx ee n 
mis	m i s 
sol	s o l 
tanindabar	t a n i nd a b a r 
taalxitteu	t aa lx i t t eu 
atxtxaippadxak	a tx tx ai p p a dx a k 
puunaiyaa	p uu n ai y aa 
uukkam	uu k k a m 
panxnxa	p a nx nx a 
kudxikkanxum	k u dx i k k a nx u m 
kamplxiitx	k a m p lx ii tx 
waruwaangga	w a r u w aa ng g a 
teewai	t ee w ai 
ndarxumanxam	nd a rx u m a nx a m 
wilxanggaadeu	w i lx a ng g aa d eu 
uuraatxcigalxil	uu r aa tx c i g a lx i l 
urxawinargalxeukkum	u rx a w i n a r g a lx eu k k u m 
sambawam	s a m b a w a m 
idanai	i d a n ai 
dxee	dx ee 
mugam	m u g a m 
uurjidam	uu r j i d a m 
aanaar	aa n aa r 
adigaarigalx	a d i g aa r i g a lx 
waitta	w ai t t a 
etxtxeu	e tx tx eu 
waanam	w aa n a m 
orkka	o r k k a 
akkaa	a k k aa 
idxam	i dx a m 
patxtxaam	p a tx tx aa m 
kaanxaada	k aa nx aa d a 
ndaappazhakkam	nd aa p p a zh a k k a m 
pirxanddaal	p i rx a nd d aa l 
weenxdxumaa	w ee nx dx u m aa 
kadambam	k a d a m b a m 
waazh	w aa zh 
mugattai	m u g a t t ai 
keaanxdxeu	k e aa nx dx eu 
perugikkonxdxee	p e r u g i k k o nx dx ee 
tawarxaagiwitxtxadeu	t a w a rx aa g i w i tx tx a d eu 
adxutta	a dx u t t a 
anxnxaaweukkeu	a nx nx aa w eu k k eu 
maada	m aa d a 
poodum	p oo d u m 
tiiyaal	t ii y aa l 
tiruppik	t i r u p p i k 
awanadeu	a w a n a d eu 
saappidxuwadarxkeu	s aa p p i dx u w a d a rx k eu 
teriyaamal	t e r i y aa m a l 
tirumbiyulxlxaargalx	t i r u m b i y u lx lx aa r g a lx 
seybawargalxin	s e y b a w a r g a lx i n 
anaittum	a n ai t t u m 
maarxupatxtxa	m aa rx u p a tx tx a 
awarkuudxa	a w a r k uu dx a 
telunggeu	t e l u ng g eu 
pugaar	p u g aa r 
ndallenxnxeyyaic	nd a l l e nx nx e y y ai c 
unxdxeu	u nx dx eu 
billa	b i l l a 
paagam	p aa g a m 
ooywinrxi	oo y w i n rx i 
paanagam	p aa n a g a m 
uyar	u y a r 
iraagawan	i r aa g a w a n 
mutxrxilumaaga	m u tx rx i l u m aa g a 
een	ee n 
edxeukkappootxtxi	e dx eu k k a p p oo tx tx i 
porulxillai	p o r u lx i l l ai 
warrxadeukkeu	w a r rx a d eu k k eu 
welxila	w e lx i l a 
oodxinaangga	oo dx i n aa ng g a 
kanxnxiir	k a nx nx ii r 
padxanggalxai	p a dx a ng g a lx ai 
wisaarikkum	w i s aa r i k k u m 
wiriwaana	w i r i w aa n a 
kalanddeukkonxdxanar	k a l a nd d eu k k o nx dx a n a r 
waittiyasaalaiyil	w ai t t i y a s aa l ai y i l 
kadxawulxeukkeuk	k a dx a w u lx eu k k eu k 
turxaiyinar	t u rx ai y i n a r 
samacciir	s a m a c c ii r 
kaasaawadeu	k aa s aa w a d eu 
ndamadeu	nd a m a d eu 
kizhanggin	k i zh a ng g i n 
aadarawaaga	aa d a r a w aa g a 
welxiyaagiyulxlxadeu	w e lx i y aa g i y u lx lx a d eu 
paambin	p aa m b i n 
oppiidxeu	o p p ii dx eu 
marxeukkirxaar	m a rx eu k k i rx aa r 
eerxpadxuginrxadeu	ee rx p a dx u g i n rx a d eu 
kaalakatxtxattil	k aa l a k a tx tx a t t i l 
ulawuwawai	u l a w u w a w ai 
samayapuram	s a m a y a p u r a m 
sonnaareu	s o n n aa r eu 
anjjal	a nj j a l 
ambalam	a m b a l a m 
waasanai	w aa s a n ai 
anbaree	a n b a r ee 
seydadeu	s e y d a d eu 
widxai	w i dx ai 
anaiwarumee	a n ai w a r u m ee 
awargalxin	a w a r g a lx i n 
inddak	i nd d a k 
unggalxeukkum	u ng g a lx eu k k u m 
wayirxeu	w a y i rx eu 
patteu	p a t t eu 
pooccaa	p oo c c aa 
senjjaa	s e nj j aa 
petxrxeu	p e tx rx eu 
wisxayanggalx	w i sx a y a ng g a lx 
keaatxeukkaamal	k e aa tx eu k k aa m a l 
darisananggalxaiyum	d a r i s a n a ng g a lx ai y u m 
maatxrxattai	m aa tx rx a t t ai 
waazha	w aa zh a 
ndadxanddeu	nd a dx a nd d eu 
mudalwarisai	m u d a l w a r i s ai 
konxdxaadxinar	k o nx dx aa dx i n a r 
illa	i l l a 
sanddippeu	s a nd d i p p eu 
koobam	k oo b a m 
oli	o l i 
padxiwadeu	p a dx i w a d eu 
iwalx	i w a lx 
wisaaranxaiyil	w i s aa r a nx ai y i l 
amaippaal	a m ai p p aa l 
alxawilaa	a lx a w i l aa 
anaiwarin	a n ai w a r i n 
ndagaramaana	nd a g a r a m aa n a 
armagedoon	a r m a g e d oo n 
ajiiranxak	a j ii r a nx a k 
pinni	p i n n i 
karugiyadeu	k a r u g i y a d eu 
sey	s e y 
olxi	o lx i 
ezhutteup	e zh u t t eu p 
arumaiyaagawulxlxadeu	a r u m ai y aa g a w u lx lx a d eu 
azhagiyadaana	a zh a g i y a d aa n a 
wimaana	w i m aa n a 
pooliisaareukkeu	p oo l ii s aa r eu k k eu 
enrxudaan	e n rx u d aa n 
porutxkalxaip	p o r u tx k a lx ai p 
edxeu	e dx eu 
kanxnxeukkeu	k a nx nx eu k k eu 
laksxanxam	l a k sx a nx a m 
uccam	u c c a m 
padxa	p a dx a 
selaawanxi	s e l aa w a nx i 
awwidxattil	a w w i dx a t t i l 
idutodxarbaaga	i d u t o dx a r b aa g a 
wizhaa	w i zh aa 
puujaigalx	p uu j ai g a lx 
kulxiccitxtxeu	k u lx i c c i tx tx eu 
panxnxeu	p a nx nx eu 
retximeetx	r e tx i m ee tx 
ndaatxtxeu	nd aa tx tx eu 
kanddaiyaanaalum	k a nd d ai y aa n aa l u m 
pirxakkum	p i rx a k k u m 
eerxpadeu	ee rx p a d eu 
tayaarikkappatxtxana	t a y aa r i k k a p p a tx tx a n a 
unxmai	u nx m ai 
kuzhappa	k u zh a p p a 
kaappaalxiniyidxamirunddeu	k aa p p aa lx i n i y i dx a m i r u nd d eu 
tootxrxattaip	t oo tx rx a t t ai p 
elxidil	e lx i d i l 
etirtteu	e t i r t t eu 
oruwar	o r u w a r 
ellai	e l l ai 
dxras	dx r a s 
ganxeesx	g a nx ee sx 
eetxtxeu	ee tx tx eu 
wenrxa	w e n rx a 
marxaiyak	m a rx ai y a k 
sinnattil	s i n n a t t i l 
rattuc	r a t t u c 
widxaadiirgalx	w i dx aa d ii r g a lx 
pugaikkum	p u g ai k k u m 
weenxdxumenrxeu	w ee nx dx u m e n rx eu 
udxambeukkeu	u dx a m b eu k k eu 
kai	k ai 
parugik	p a r u g i k 
sutxtxikkaanxpikkirxaargalx	s u tx tx i k k aa nx p i k k i rx aa r g a lx 
talxaraamal	t a lx a r aa m a l 
arasiyaleukkeu	a r a s i y a l eu k k eu 
asaamin	a s aa m i n 
munwanddeen	m u n w a nd d ee n 
keetxtxaargalx	k ee tx tx aa r g a lx 
irumal	i r u m a l 
kaarttikeeyan	k aa r t t i k ee y a n 
utxkaara	u tx k aa r a 
wanxangginaan	w a nx a ng g i n aa n 
alxaweukkeu	a lx a w eu k k eu 
tinnaadeu	t i n n aa d eu 
miinawan	m ii n a w a n 
sonnaan	s o n n aa n 
konxdxum	k o nx dx u m 
poonaan	p oo n aa n 
kaiyil	k ai y i l 
parawuwadeu	p a r a w u w a d eu 
awatxrxin	a w a tx rx i n 
eemaatxrxattai	ee m aa tx rx a t t ai 
kuzhanddaippeerxeukkaaga	k u zh a nd d ai p p ee rx eu k k aa g a 
jadxai	j a dx ai 
unxmaiyee	u nx m ai y ee 
senrxeu	s e n rx eu 
makkalx	m a k k a lx 
aanaal	aa n aa l 
ottirunddadeu	o t t i r u nd d a d eu 
inddap	i nd d a p 
kodxuppoom	k o dx u p p oo m 
payanpadxuttinaargalx	p a y a n p a dx u t t i n aa r g a lx 
muunrxeu	m uu n rx eu 
unakkeuk	u n a k k eu k 
pilxatx	p i lx a tx 
litxtxar	l i tx tx a r 
taniyaa	t a n i y aa 
tootxtxattai	t oo tx tx a t t ai 
meegam	m ee g a m 
ndiikkeu	nd ii k k eu 
awaridxam	a w a r i dx a m 
seyyunggalx	s e y y u ng g a lx 
kaaranxanggalxellaam	k aa r a nx a ng g a lx e l l aa m 
muganduul	m u g a nd uu l 
poorxeen	p oo rx ee n 
wazhiyaip	w a zh i y ai p 
arxuppadeu	a rx u p p a d eu 
manx	m a nx 
pootxtxiyil	p oo tx tx i y i l 
wilai	w i l ai 
ezhutteukkalx	e zh u t t eu k k a lx 
ndawiina	nd a w ii n a 
keemaraa	k ee m a r aa 
pooliisaar	p oo l ii s aa r 
saappitxtxeu	s aa p p i tx tx eu 
hetx	h e tx 
dxelli	dx e l l i 
irunddana	i r u nd d a n a 
yoosikka	y oo s i k k a 
odeukkappatxtxa	o d eu k k a p p a tx tx a 
pootxtxeu	p oo tx tx eu 
ndiccayam	nd i c c a y a m 
unakkeu	u n a k k eu 
wisxayattaik	w i sx a y a t t ai k 
wizhunddeu	w i zh u nd d eu 
tolaikkaatxci	t o l ai k k aa tx c i 
adirsxtxam	a d i r sx tx a m 
poodee	p oo d ee 
todxarpaaga	t o dx a r p aa g a 
eelattin	ee l a t t i n 
edxutteukkolxlxunggalx	e dx u t t eu k k o lx lx u ng g a lx 
weelxaanx	w ee lx aa nx 
widikka	w i d i k k a 
seyyappatxtxeu	s e y y a p p a tx tx eu 
saappaadxeu	s aa p p aa dx eu 
manidan	m a n i d a n 
muyarxci	m u y a rx c i 
seetxtxai	s ee tx tx ai 
uunam	uu n a m 
ndiyaayam	nd i y aa y a m 
kitxaikkumee	k i dx ai k k u m ee 
kuuccal	k uu c c a l 
kiizhee	k ii zh ee 
alxawil	a lx a w i l 
aasiirwaadanggalxai	aa s ii r w aa d a ng g a lx ai 
timeuka	t i m eu k a 
enrxee	e n rx ee 
witxtxeup	w i tx tx eu p 
eppoo	e p p oo 
pirxareukkeu	p i rx a r eu k k eu 
wadxiwamaippeu	w a dx i w a m ai p p eu 
alla	a l l a 
ndookki	nd oo k k i 
aatxrxalai	aa tx rx a l ai 
weelaiyum	w ee l ai y u m 
tanggalx	t a ng g a lx 
payanpatxuttik	p a y a n p a dx u t t i k 
swiitx	s w ii tx 
ndirxainddadeu	nd i rx ai nd d a d eu 
dusxtxan	d u sx tx a n 
ndilaiyam	nd i l ai y a m 
kunggumam	k u ng g u m a m 
magudxi	m a g u dx i 
mudxi	m u dx i 
warxutta	w a rx u t t a 
ndaam	nd aa m 
matxtxuminrxi	m a tx tx u m i n rx i 
wadakkawum	w a d a k k a w u m 
kadxawulxeukkeu	k a dx a w u lx eu k k eu 
uruwaagi	u r u w aa g i 
idudaan	i d u d aa n 
kaawal	k aa w a l 
welxiyidxappadxum	w e lx i y i dx a p p a dx u m 
ndalkonxdxaa	nd a l k o nx dx aa 
panxnxinaa	p a nx nx i n aa 
anubawamulxlxa	a n u b a w a m u lx lx a 
irunddaar	i r u nd d aa r 
iwai	i w ai 
kidxaiyaadeu	k i dx ai y aa d eu 
wagikkinrxana	w a g i k k i n rx a n a 
idaiyeaatxtxi	i d ai y e aa tx tx i 
porxumaikkum	p o rx u m ai k k u m 
siiwanum	s ii w a n u m 
waraangga	w a r aa ng g a 
widxudalai	w i dx u d a l ai 
uureukkeu	uu r eu k k eu 
aaltxtxoo	aa l tx tx oo 
eerxpatxtxadeu	ee rx p a tx tx a d eu 
anxiyin	a nx i y i n 
kiira	k ii r a 
anjjali	a nj j a l i 
ippadxi	i p p a dx i 
meukkiyamaana	m eu k k i y a m aa n a 
txaas	tx aa s 
kurxaiyawillai	k u rx ai y a w i l l ai 
poowadeu	p oo w a d eu 
ndanrxiyaay	nd a n rx i y aa y 
illaiyaa	i l l ai y aa 
widattil	w i d a t t i l 
kiizhppadxiyaamal	k ii zh p p a dx i y aa m a l 
sammadittaar	s a m m a d i t t aa r 
tanxdxuwadxattil	t a nx dx u w a dx a t t i l 
talxlxi	t a lx lx i 
eksaamla	e k s aa m l a 
ndekstx	nd e k s tx 
ilxamaiyil	i lx a m ai y i l 
iwar	i w a r 
selgirxadeu	s e l g i rx a d eu 
kaarai	k aa r ai 
peesaadee	p ee s aa d ee 
adxaiya	a dx ai y a 
piridal	p i r i d a l 
murxaiyaanadeu	m u rx ai y aa n a d eu 
onrxaam	o n rx aa m 
maambazham	m aa m b a zh a m 
katxtxiyawar	k a tx tx i y a w a r 
taa	t aa 
muunrxaam	m uu n rx aa m 
ippootxtxiyin	i p p oo tx tx i y i n 
maatxrxanggalx	m aa tx rx a ng g a lx 
unggalxai	u ng g a lx ai 
sonnaangga	s o n n aa ng g a 
partdxeekkeu	p a r t dx ee k k eu 
awan	a w a n 
dinamum	d i n a m u m 
tirumanxam	t i r u m a nx a m 
kodxi	k o dx i 
talaiwar	t a l ai w a r 
awareukkeu	a w a r eu k k eu 
weega	w ee g a 
kolxlxalaam	k o lx lx a l aa m 
puukkalx	p uu k k a lx 
ndilaiyattil	nd i l ai y a t t i l 
wej	w e j 
guloopjaamun	g u l oo p j aa m u n 
idxeu	i dx eu 
accamillaadawan	a c c a m i l l aa d a w a n 
kadxarxkaraikkeu	k a dx a rx k a r ai k k eu 
paarkkattaan	p aa r k k a t t aa n 
ndidiyudawi	nd i d i y u d a w i 
mudxiyum	m u dx i y u m 
suudaatxtxam	s uu d aa tx tx a m 
tamizhagattil	t a m i zh a g a t t i l 
sanddarppanggalx	s a nd d a r p p a ng g a lx 
poodxeu	p oo dx eu 
kaalamellaam	k aa l a m e l l aa m 
oppudal	o p p u d a l 
eppadxi	e p p a dx i 
weelai	w ee l ai 
kaaranxam	k aa r a nx a m 
doosaiyum	d oo s ai y u m 
kuuppidxungga	k uu p p i dx u ng g a 
diipaawalxikkeu	d ii p aa w a lx i k k eu 
pudusaa	p u d u s aa 
panjjeu	p a nj j eu 
udawum	u d a w u m 
sxasxtxi	sx a sx tx i 
usxaa	u sx aa 
kadxaleukkulx	k a dx a l eu k k u lx 
wizhaiyawillai	w i zh ai y a w i l l ai 
silareukkeu	s i l a r eu k k eu 
piriwugalx	p i r i w u g a lx 
ireukkirxadeu	i r eu k k i rx a d eu 
ulxlxadeu	u lx lx a d eu 
taralaanaar	t a r a l aa n aa r 
kuzheu	k u zh eu 
sariyaagum	s a r i y aa g u m 
warumaa	w a r u m aa 
adxaippeu	a dx ai p p eu 
karam	k a r a m 
tiitxtxeu	t ii tx tx eu 
eezhai	ee zh ai 
aaramba	aa r a m b a 
tawirkka	t a w i r k k a 
kulxircci	k u lx i r c c i 
uruwaakkiyadeu	u r u w aa k k i y a d eu 
iyareukkeu	i y a r eu k k eu 
yaar	y aa r 
uyirizhanddanar	u y i r i zh a nd d a n a r 
warisaiyaaga	w a r i s ai y aa g a 
aaraaywadan	aa r aa y w a d a n 
renxdxeu	r e nx dx eu 
laksxmi	l a k sx m i 
ndiidxikkum	nd ii dx i k k u m 
pereu	p e r eu 
kadxawulx	k a dx a w u lx 
tagawalum	t a g a w a l u m 
mooganlaal	m oo g a n l aa l 
penxgalxin	p e nx g a lx i n 
arxiwiyalilirunddeu	a rx i w i y a l i l i r u nd d eu 
ellaam	e l l aa m 
paar	p aa r 
biins	b ii n s 
wilanggeu	w i l a ng g eu 
saram	s a r a m 
kudxisai	k u dx i s ai 
wiraiwil	w i r ai w i l 
katxaigalx	k a dx ai g a lx 
wazhanggiyulxlxadeu	w a zh a ng g i y u lx lx a d eu 
wadxiwamaikkappatxtxadeu	w a dx i w a m ai k k a p p a tx tx a d eu 
padxiwanggalxai	p a dx i w a ng g a lx ai 
arulxuwaar	a r u lx u w aa r 
ndagarnddeu	nd a g a r nd d eu 
tii	t ii 
teriwittulxlxaar	t e r i w i t t u lx lx aa r 
siiraana	s ii r aa n a 
aaktxar	aa k tx a r 
dxenggeu	dx e ng g eu 
maawai	m aa w ai 
paapkaan	p aa p k aa n 
panxnxaangga	p a nx nx aa ng g a 
ndaalxaikkeu	nd aa lx ai k k eu 
baaradam	b aa r a d a m 
padxitteup	p a dx i t t eu p 
yaarum	y aa r u m 
kodxeukkum	k o dx eu k k u m 
enxkaatxtxi	e nx k aa tx tx i 
wallamaimikka	w a l l a m ai m i k k a 
amaittirunddaar	a m ai t t i r u nd d aa r 
wiirargalxil	w ii r a r g a lx i l 
payirgalxai	p a y i r g a lx ai 
soolxam	s oo lx a m 
edxeukkappatxtxa	e dx eu k k a p p a tx tx a 
puzhudi	p u zh u d i 
piras	p i r a s 
pootxtxiyidxum	p oo tx tx i y i dx u m 
kaatxeu	k aa dx eu 
bajanai	b a j a n ai 
ndinaippaan	nd i n ai p p aa n 
agattin	a g a t t i n 
marunddait	m a r u nd d ai t 
ippadxattil	i p p a dx a t t i l 
wisaaranxaiyaalxaraaga	w i s aa r a nx ai y aa lx a r aa g a 
yaaraiyum	y aa r ai y u m 
enggalxeukkeu	e ng g a lx eu k k eu 
wanddaareu	w a nd d aa r eu 
waazhalaam	w aa zh a l aa m 
paccai	p a c c ai 
karumbeu	k a r u m b eu 
waarattin	w aa r a t t i n 
paaynddaal	p aa y nd d aa l 
eerxpatxtxaalum	ee rx p a tx tx aa l u m 
tagawalgalx	t a g a w a l g a lx 
idai	i d ai 
tirumanxa	t i r u m a nx a 
taalxikkum	t aa lx i k k u m 
enawee	e n a w ee 
futx	f u tx 
redxiyaa	r e dx i y aa 
toguppeu	t o g u p p eu 
harisxtxam	h a r i sx tx a m 
ndutxpa	nd u tx p a 
iwatxrxai	i w a tx rx ai 
tarunxam	t a r u nx a m 
urxudiyaaga	u rx u d i y aa g a 
teriyum	t e r i y u m 
txestx	tx e s tx 
seetubadi	s ee t u b a d i 
kodxiyadeu	k o dx i y a d eu 
otxtxagam	o tx tx a g a m 
palxlxiyil	p a lx lx i y i l 
hastam	h a s t a m 
karxikkeu	k a rx i k k eu 
alxippadaaga	a lx i p p a d aa g a 
gawani	g a w a n i 
ilxainjarai	i lx ai nj a r ai 
wari	w a r i 
kaappaalxar	k aa p p aa lx a r 
keelxwigalx	k ee lx w i g a lx 
pugaippadxanggalx	p u g ai p p a dx a ng g a lx 
unnoodxa	u n n oo dx a 
panxnxala	p a nx nx a l a 
seernddeukurxeen	s ee r nd d eu k u rx ee n 
mitxtxaay	m i tx tx aa y 
ndadxai	nd a dx ai 
eerxuwaan	ee rx u w aa n 
otxrxumaiyee	o tx rx u m ai y ee 
irxaiwaneukkee	i rx ai w a n eu k k ee 
pooraatxtxattirxkeu	p oo r aa tx tx a t t i rx k eu 
unggalxeukkeuk	u ng g a lx eu k k eu k 
keetxtxeu	k ee tx tx eu 
ena	e n a 
warac	w a r a c 
palxlxikkeup	p a lx lx i k k eu p 
adiga	a d i g a 
ndanrxiyoodxeu	nd a n rx i y oo dx eu 
arisi	a r i s i 
spoortxs	s p oo r tx s 
janamee	j a n a m ee 
mannarai	m a n n a r ai 
sirxuwar	s i rx u w a r 
maleeriyaa	m a l ee r i y aa 
pazhakkam	p a zh a k k a m 
ettanai	e t t a n ai 
kanxdxanggalxaiyum	k a nx dx a ng g a lx ai y u m 
weenxum	w ee nx u m 
wai	w ai 
eksasais	e k s a s ai s 
peesinaar	p ee s i n aa r 
raajaa	r aa j aa 
toonrxiya	t oo n rx i y a 
iratxtxai	i r a tx tx ai 
siwil	s i w i l 
ideu	i d eu 
kadaandaayaganaaga	k a d aa nd aa y a g a n aa g a 
pisaa	p i s aa 
arasareukkeu	a r a s a r eu k k eu 
seybawargalx	s e y b a w a r g a lx 
suurxaawalxip	s uu rx aa w a lx i p 
tiiwira	t ii w i r a 
puusaiyaa	p uu s ai y aa 
unxawinrxi	u nx a w i n rx i 
wenggaayam	w e ng g aa y a m 
tareen	t a r ee n 
pidxikkaada	p i dx i k k aa d a 
panjjaayatteu	p a nj j aa y a t t eu 
parxanddadeu	p a rx a nd d a d eu 
ndaanxam	nd aa nx a m 
jagam	j a g a m 
porxuppeu	p o rx u p p eu 
ruubaayin	r uu b aa y i n 
migundda	m i g u nd d a 
seyarxkaikkoolx	s e y a rx k ai k k oo lx 
perxum	p e rx u m 
manamodxinddeu	m a n a m o dx i nd d eu 
karektx	k a r e k tx 
sirxanddadeu	s i rx a nd d a d eu 
ndunggeu	nd u ng g eu 
tanggam	t a ng g a m 
uruppadxaadeu	u r u p p a dx aa d eu 
ootxtxeukkeu	oo tx tx eu k k eu 
kalwiyai	k a l w i y ai 
puromoosxan	p u r o m oo sx a n 
anjjaliyum	a nj j a l i y u m 
iyarxkai	i y a rx k ai 
saappidxarxadeukkeu	s aa p p i dx a rx a d eu k k eu 
uyaramaanadeu	u y a r a m aa n a d eu 
katxrxeut	k a tx rx eu t 
siiragam	s ii r a g a m 
praitx	p r ai tx 
hiiroo	h ii r oo 
wanddaal	w a nd d aa l 
madippeu	m a d i p p eu 
sarinddeu	s a r i nd d eu 
todxarnddeen	t o dx a r nd d ee n 
unxmaiyil	u nx m ai y i l 
iwwizhaawaiyotxtxi	i w w i zh aa w ai y o tx tx i 
seluttinaar	s e l u t t i n aa r 
talai	t a l ai 
poorxoom	p oo rx oo m 
welxindaatxtxuc	w e lx i nd aa tx tx u c 
suwadxeu	s u w a dx eu 
keaadxuppadarxkaaga	k e aa dx u p p a d a rx k aa g a 
welxlxaik	w e lx lx ai k 
uzhaiyunggalx	u zh ai y u ng g a lx 
warugirxadeu	w a r u g i rx a d eu 
ulxlxana	u lx lx a n a 
floorla	f l oo r l a 
akkaraip	a k k a r ai p 
paarttaal	p aa r t t aa l 
waayppulxlxadaaga	w aa y p p u lx lx a d aa g a 
petxrxawai	p e tx rx a w ai 
owworeu	o w w o r eu 
adigaarappuuaawa	a d i g aa r a p p uu aa w a 
dxaaktxara	dx aa k tx a r a 
poogumpoodeu	p oo g u m p oo d eu 
togudi	t o g u d i 
selutteu	s e l u t t eu 
taagam	t aa g a m 
ndambikkai	nd a m b i k k ai 
oowiyar	oo w i y a r 
kanxdxupidxikkap	k a nx dx u p i dx i k k a p 
saappidxalaamaa	s aa p p i dx a l aa m aa 
ranning	r a n n i ng 
waccireukkaangga	w a c c i r eu k k aa ng g a 
irubatti	i r u b a t t i 
keetxpadeu	k ee tx p a d eu 
puujai	p uu j ai 
kalwiyee	k a l w i y ee 
payanadxaiginrxanar	p a y a n a dx ai g i n rx a n a r 
inddiyasiina	i nd d i y a s ii n a 
keetxka	k ee tx k a 
tiruppeu	t i r u p p eu 
aarwam	aa r w a m 
maruttuwamanaikkeu	m a r u t t u w a m a n ai k k eu 
wisaarikkinrxanar	w i s aa r i k k i n rx a n a r 
ndadxakkirxawargalxai	nd a dx a k k i rx a w a r g a lx ai 
ettana	e t t a n a 
maiyanggalx	m ai y a ng g a lx 
sugaadaaram	s u g aa d aa r a m 
kasxaayam	k a sx aa y a m 
konxdxadeu	k o nx dx a d eu 
ezhudiyulxlxaar	e zh u d i y u lx lx aa r 
txyuun	tx y uu n 
help	h e l p 
peydadeu	p e y d a d eu 
welxiccattirxkeu	w e lx i c c a t t i rx k eu 
satxtxanggalxaiyum	s a tx tx a ng g a lx ai y u m 
pugaippadxanggalxil	p u g ai p p a dx a ng g a lx i l 
katxcikkum	k a tx c i k k u m 
ndadxatta	nd a dx a t t a 
tamizh	t a m i zh 
erinddadeu	e r i nd d a d eu 
oreu	o r eu 
pinbeu	p i n b eu 
katxtxanxaminrxi	k a tx tx a nx a m i n rx i 
dxaaktxaraana	dx aa k tx a r aa n a 
kannadxam	k a n n a dx a m 
ndadxaimurxaigalx	nd a dx ai m u rx ai g a lx 
konxdxa	k o nx dx a 
ndallaa	nd a l l aa 
taangga	t aa ng g a 
poola	p oo l a 
ndeeratteukkeu	nd ee r a t t eu k k eu 
awatxrxulx	a w a tx rx u lx 
ireukkac	i r eu k k a c 
anddap	a nd d a p 
aatxtxattil	aa tx tx a t t i l 
iduwarai	i d u w a r ai 
adeep	a d ee p 
pingg	p i ng g 
enrxeu	e n rx eu 
pazhakkanggalxaaginrxana	p a zh a k k a ng g a lx aa g i n rx a n a 
ndinaiweu	nd i n ai w eu 
talaimaiyil	t a l ai m ai y i l 
tanittuwamaana	t a n i t t u w a m aa n a 
samaalxikka	s a m aa lx i k k a 
ndiikkappadxa	nd ii k k a p p a dx a 
pinwarumaarxeu	p i n w a r u m aa rx eu 
teerdal	t ee r d a l 
ammaawa	a m m aa w a 
fangsxanla	f a ng sx a n l a 
waay	w aa y 
siwappeu	s i w a p p eu 
senrxa	s e n rx a 
witxtxiirgalxaa	w i tx tx ii r g a lx aa 
iwarai	i w a r ai 
wizhunddadil	w i zh u nd d a d i l 
apdxeetx	a p dx ee tx 
ootxtxap	oo tx tx a p 
widxuttulxlxa	w i dx u t t u lx lx a 
kiirai	k ii r ai 
ndaatxtxil	nd aa tx tx i l 
unxarwin	u nx a r w i n 
konxdxadai	k o nx dx a d ai 
ulxlxee	u lx lx ee 
edxutteukkitxtxeen	e dx u t t eu k k i tx tx ee n 
panggeerxpadarxkaaga	p a ng g ee rx p a d a rx k aa g a 
kanxdxupidxikka	k a nx dx u p i dx i k k a 
togutteu	t o g u t t eu 
ndeeramillai	nd ee r a m i l l ai 
teewaippadxuwoor	t ee w ai p p a dx u w oo r 
inddiyaawin	i nd d i y aa w i n 
pootxtxaangga	p oo tx tx aa ng g a 
tiirweu	t ii r w eu 
urxinjji	u rx i nj j i 
suuranxam	s uu r a nx a m 
pullum	p u l l u m 
ganxeesanait	g a nx ee s a n ai t 
tanxdxitteu	t a nx dx i t t eu 
anrxeu	a n rx eu 
eedaawadoreu	ee d aa w a d o r eu 
sarkkarai	s a r k k a r ai 
kalluuriyilee	k a l l uu r i y i l ee 
ireukkaa	i r eu k k aa 
wanddaa	w a nd d aa 
jaadi	j aa d i 
anxnxaa	a nx nx aa 
manamee	m a n a m ee 
satxrxeu	s a tx rx eu 
anjjaligalx	a nj j a l i g a lx 
kanxaiyattinaal	k a nx ai y a t t i n aa l 
insulin	i n s u l i n 
wetxtxik	w e tx tx i k 
wizhaawai	w i zh aa w ai 
welxiyitxtxeu	w e lx i y i tx tx eu 
uyarnddadeu	u y a r nd d a d eu 
enrxaan	e n rx aa n 
irunddadeu	i r u nd d a d eu 
wiwaram	w i w a r a m 
aanaa	aa n aa 
keetxkat	k ee tx k a t 
ponggaleukkeu	p o ng g a l eu k k eu 
kuudxudalaaga	k uu dx u d a l aa g a 
awar	a w a r 
anumadikkappatxtxulxlxanar	a n u m a d i k k a p p a tx tx u lx lx a n a r 
waanggi	w aa ng g i 
gaanddi	g aa nd d i 
seyaleukkeut	s e y a l eu k k eu t 
tayaar	t a y aa r 
abaayanggalx	a b aa y a ng g a lx 
enxkanxidattil	e nx k a nx i d a t t i l 
ida	i d a 
talaikkeu	t a l ai k k eu 
eepral	ee p r a l 
aarjidam	aa r j i d a m 
werxiccoodxi	w e rx i c c oo dx i 
kuutxtxikkolxgirxadeu	k uu tx tx i k k o lx g i rx a d eu 
tarum	t a r u m 
maatxrxattaal	m aa tx rx a t t aa l 
pirxa	p i rx a 
parxippeu	p a rx i p p eu 
em	e m 
parappappatxtxadeu	p a r a p p a p p a tx tx a d eu 
panxrxiinggalxaa	p a nx rx ii ng g a lx aa 
appurxamaa	a p p u rx a m aa 
sariyaa	s a r i y aa 
malar	m a l a r 
suuniyam	s uu n i y a m 
tinbadeu	t i n b a d eu 
paruppugalxai	p a r u p p u g a lx ai 
inggeu	i ng g eu 
paasana	p aa s a n a 
panddaya	p a nd d a y a 
tadxawi	t a dx a w i 
ndaadxinaar	nd aa dx i n aa r 
sirxappamsanggalx	s i rx a p p a m s a ng g a lx 
saagupadxi	s aa g u p a dx i 
hootxdxaleukkeu	h oo tx dx a l eu k k eu 
illaiyadxi	i l l ai y a dx i 
lajjai	l a j j ai 
ndil	nd i l 
uuham	uu h a m 
wanddaar	w a nd d aa r 
kuuwum	k uu w u m 
kadxawulxai	k a dx a w u lx ai 
yaaraawadeu	y aa r aa w a d eu 
samuugattinaraiyum	s a m uu g a t t i n a r ai y u m 
porutxkalx	p o r u tx k a lx 
aabatteu	aa b a t t eu 
paarkka	p aa r k k a 
idan	i d a n 
txrai	tx r ai 
tirumbawum	t i r u m b a w u m 
sisxyan	s i sx y a n 
sanddoosxamaaga	s a nd d oo sx a m aa g a 
kanjji	k a nj j i 
oodxi	oo dx i 
ndilaiya	nd i l ai y a 
kurxainddeukonxdxee	k u rx ai nd d eu k o nx dx ee 
sonnadaiyee	s o n n a d ai y ee 
peesuwadeu	p ee s u w a d eu 
badil	b a d i l 
sanggattil	s a ng g a t t i l 
toolxaippidxitteu	t oo lx ai p p i dx i t t eu 
kambeu	k a m b eu 
ammaa	a m m aa 
saappitxtxaa	s aa p p i tx tx aa 
ireukkaangga	i r eu k k aa ng g a 
wasadiyaa	w a s a d i y aa 
katxtxaadee	k a tx tx aa d ee 
kasxtxam	k a sx tx a m 
eewuganxai	ee w u g a nx ai 
deesatteu	d ee s a t t eu 
illai	i l l ai 
muyarxciseygirxaargalx	m u y a rx c i s e y g i rx aa r g a lx 
pooraatxtxa	p oo r aa tx tx a 
iidxupatxtxanar	ii dx u p a tx tx a n a r 
sigiccaigalxin	s i g i c c ai g a lx i n 
tawir	t a w i r 
teejas	t ee j a s 
aatxrxin	aa tx rx i n 
seyyalaam	s e y y a l aa m 
teerdalil	t ee r d a l i l 
kadxamaiyil	k a dx a m ai y i l 
sanddikka	s a nd d i k k a 
arasaangga	a r a s aa ng g a 
appadxi	a p p a dx i 
sirxappaaga	s i rx a p p aa g a 
pootxrxi	p oo tx rx i 
aatxciyargalx	aa tx c i y a r g a lx 
ireukkaigalxil	i r eu k k ai g a lx i l 
konxdxireukkirxadeu	k o nx dx i r eu k k i rx a d eu 
piriyaanxi	p i r i y aa nx i 
heenxtx	h ee nx tx 
sellum	s e l l u m 
seyalpadxeu	s e y a l p a dx eu 
ndirxaindda	nd i rx ai nd d a 
pusxpam	p u sx p a m 
seyyin	s e y y i n 
waaraa	w aa r aa 
ndari	nd a r i 
tangguwadarxkeu	t a ng g u w a d a rx k eu 
wella	w e l l a 
alxikkappadxum	a lx i k k a p p a dx u m 
meukkiya	m eu k k i y a 
teewaiyaana	t ee w ai y aa n a 
jalsakti	j a l s a k t i 
marunddeu	m a r u nd d eu 
restx	r e s tx 
wanxanggeu	w a nx a ng g eu 
lanjja	l a nj j a 
kaanjjipuram	k aa nj j i p u r a m 
kattirikkaay	k a t t i r i k k aa y 
ezheu	e zh eu 
ireukkum	i r eu k k u m 
konxdxeen	k o nx dx ee n 
iccambawattil	i c c a m b a w a t t i l 
uriya	u r i y a 
kuurxinaar	k uu rx i n aa r 
awwalxaweu	a w w a lx a w eu 
moosamaaga	m oo s a m aa g a 
itxli	i tx l i 
mayakkam	m a y a k k a m 
teriyumaa	t e r i y u m aa 
wiitxtxila	w ii tx tx i l a 
panxnxireukkaangga	p a nx nx i r eu k k aa ng g a 
kaappiyaanadeu	k aa p p i y aa n a d eu 
yuuniyan	y uu n i y a n 
samayattil	s a m a y a t t i l 
patxrxaakkurxai	p a tx rx aa k k u rx ai 
waariyatteukkaana	w aa r i y a t t eu k k aa n a 
urxcaagamaaga	u rx c aa g a m aa g a 
maarc	m aa r c 
anuppa	a n u p p a 
kari	k a r i 
kolxlxaadee	k o lx lx aa d ee 
patxtxeu	p a tx tx eu 
udxaiyaar	u dx ai y aa r 
andndiyac	a nd nd i y a c 
amaikkappadxum	a m ai k k a p p a dx u m 
weenxdxaam	w ee nx dx aa m 
keelxwigalxai	k ee lx w i g a lx ai 
awarait	a w a r ai t 
elxiya	e lx i y a 
patxjetx	p a tx j e tx 
sinnadaa	s i n n a d aa 
ezhudanxum	e zh u d a nx u m 
tozhilil	t o zh i l i l 
illaadawan	i l l aa d a w a n 
aatxrxil	aa tx rx i l 
idil	i d i l 
kaayam	k aa y a m 
pinpatxrxa	p i n p a tx rx a 
kurxitteuk	k u rx i t t eu k 
mozhi	m o zh i 
pori	p o r i 
ndagaranggalx	nd a g a r a ng g a lx 
waraweerxpai	w a r a w ee rx p ai 
peyar	p e y a r 
suzhatxrxeu	s u zh a tx rx eu 
padxutteu	p a dx u t t eu 
marunddai	m a r u nd d ai 
ndaalx	nd aa lx 
irunddeu	i r u nd d eu 
appagudiyil	a p p a g u d i y i l 
ulxlxadaagawum	u lx lx a d aa g a w u m 
taawarattin	t aa w a r a t t i n 
talaigalx	t a l ai g a lx 
wazhimurxaigalxai	w a zh i m u rx ai g a lx ai 
wazhanggappatxtxadeu	w a zh a ng g a p p a tx tx a d eu 
angga	a ng g a 
kodxeu	k o dx eu 
panxamaa	p a nx a m aa 
waangga	w aa ng g a 
talxlxip	t a lx lx i p 
irundduccaa	i r u nd d u c c aa 
muulxai	m uu lx ai 
todxanggiyadeu	t o dx a ng g i y a d eu 
wazhipaatxtxinboodeu	w a zh i p aa tx tx i n b oo d eu 
adanaal	a d a n aa l 
kadaiyaay	k a d ai y aa y 
erikkappatxtxana	e r i k k a p p a tx tx a n a 
ndadxatti	nd a dx a t t i 
tayaarikka	t a y aa r i k k a 
aacceu	aa c c eu 
asuran	a s u r a n 
erxinddadeu	e rx i nd d a d eu 
sanddai	s a nd d ai 
ulagak	u l a g a k 
pooraatxtxattil	p oo r aa tx tx a t t i l 
etirppadxugirxaargalx	e t i r p p a dx u g i rx aa r g a lx 
iruppadaiyee	i r u p p a d ai y ee 
aagum	aa g u m 
selutta	s e l u t t a 
mudalwareukkeu	m u d a l w a r eu k k eu 
makkalxum	m a k k a lx u m 
samaikkirxaangga	s a m ai k k i rx aa ng g a 
sariyaayidxum	s a r i y aa y i dx u m 
sais	s ai s 
maatxc	m aa tx c 
majjai	m a j j ai 
oruwan	o r u w a n 
amaiccar	a m ai c c a r 
idanaal	i d a n aa l 
pookka	p oo k k a 
seywaan	s e y w aa n 
miirxinaal	m ii rx i n aa l 
selwam	s e l w a m 
minnuwadeu	m i n n u w a d eu 
sonnaar	s o n n aa r 
tawarxaaga	t a w a rx aa g a 
murxitteuk	m u rx i t t eu k 
awalx	a w a lx 
poonaar	p oo n aa r 
purofasxan	p u r o f a sx a n 
adxaiyaalxamaagawum	a dx ai y aa lx a m aa g a w u m 
poodxa	p oo dx a 
meejai	m ee j ai 
nduraiyiiral	nd u r ai y ii r a l 
perunddiraalxaana	p e r u nd d i r aa lx aa n a 
porxeu	p o rx eu 
seyal	s e y a l 
weenxdxiyireukkirxadeu	w ee nx dx i y i r eu k k i rx a d eu 
ulaga	u l a g a 
peeranxiyil	p ee r a nx i y i l 
katxtxuppaadxeu	k a tx tx u p p aa dx eu 
koowaa	k oo w aa 
pagudigalx	p a g u d i g a lx 
teenggiyadeu	t ee ng g i y a d eu 
pal	p a l 
kaanxeu	k aa nx eu 
panjjaanggam	p a nj j aa ng g a m 
anbee	a n b ee 
wanddadeu	w a nd d a d eu 
sirxuwargalx	s i rx u w a r g a lx 
enxnxai	e nx nx ai 
warum	w a r u m 
palxlxi	p a lx lx i 
konxdxulxlxanar	k o nx dx u lx lx a n a r 
idxampetxrxulxlxadeu	i dx a m p e tx rx u lx lx a d eu 
wilxaiyaatxtxumeeyanrxi	w i lx ai y aa tx tx u m ee y a n rx i 
partdxee	p a r t dx ee 
wiidi	w ii d i 
kaigalxai	k ai g a lx ai 
igazhcci	i g a zh c c i 
waruginrxanar	w a r u g i n rx a n a r 
saanrxeu	s aa n rx eu 
panxnxalaam	p a nx nx a l aa m 
tanddadeu	t a nd d a d eu 
sollittarrxeen	s o l l i t t a r rx ee n 
balam	b a l a m 
penx	p e nx 
idaik	i d ai k 
eerxpatxtxadaaga	ee rx p a tx tx a d aa g a 
awai	a w ai 
maawatxtxa	m aa w a tx tx a 
alxaweu	a lx a w eu 
ndaanee	nd aa n ee 
teppam	t e p p a m 
manxal	m a nx a l 
tirumba	t i r u m b a 
aarambiccidxum	aa r a m b i c c i dx u m 
widxiyum	w i dx i y u m 
kanxidam	k a nx i d a m 
kidxaikkum	k i dx ai k k u m 
makkalxai	m a k k a lx ai 
kiizh	k ii zh 
ilakkugalxai	i l a k k u g a lx ai 
inddappaadaiyil	i nd d a p p aa d ai y i l 
ndamakkeu	nd a m a k k eu 
keeli	k ee l i 
iwaradeu	i w a r a d eu 
sariyaayidxumneu	s a r i y aa y i dx u m n eu 
poodxuwaangga	p oo dx u w aa ng g a 
kiizhoor	k ii zh oo r 
pirabala	p i r a b a l a 
ndiyaayamaanawaidaan	nd i y aa y a m aa n a w ai d aa n 
idupoola	i d u p oo l a 
udawi	u d a w i 
unggalxudxaiya	u ng g a lx u dx ai y a 
kamalahaasan	k a m a l a h aa s a n 
matxrxoreu	m a tx rx o r eu 
keelxwiyaik	k ee lx w i y ai k 
weenxdxaamaa	w ee nx dx aa m aa 
sariyilla	s a r i y i l l a 
sollungga	s o l l u ng g a 
kulxiccutxtxeu	k u lx i c c u tx tx eu 
eetxrxam	ee tx rx a m 
raagam	r aa g a m 
wallawaneukkeup	w a l l a w a n eu k k eu p 
pasittaalum	p a s i t t aa l u m 
puunai	p uu n ai 
eetxrxumadi	ee tx rx u m a d i 
adxipanxiya	a dx i p a nx i y a 
awaraik	a w a r ai k 
meyin	m e y i n 
porulxgalx	p o r u lx g a lx 
sigiccaikkeu	s i g i c c ai k k eu 
arxiwiyaleukkeu	a rx i w i y a l eu k k eu 
udxanpaatxtxirxkeu	u dx a n p aa tx tx i rx k eu 
wirudeu	w i r u d eu 
wiikkili	w ii k k i l i 
saakleetx	s aa k l ee tx 
ndam	nd a m 
peerunddeu	p ee r u nd d eu 
ireukkaan	i r eu k k aa n 
awasara	a w a s a r a 
tudxippaana	t u dx i p p aa n a 
maadattirxkeu	m aa d a t t i rx k eu 
ndanrxaaga	nd a n rx aa g a 
kaattireukkeen	k aa t t i r eu k k ee n 
awaroodxa	a w a r oo dx a 
seydidxuga	s e y d i dx u g a 
oor	oo r 
saanrxidazhum	s aa n rx i d a zh u m 
todxarbaaga	t o dx a r b aa g a 
sariyaanadeu	s a r i y aa n a d eu 
waliyadeu	w a l i y a d eu 
ireu	i r eu 
paarttireukkirxeen	p aa r t t i r eu k k i rx ee n 
munbaaga	m u n b aa g a 
ndiikki	nd ii k k i 
matxrxum	m a tx rx u m 
wisaaranxai	w i s aa r a nx ai 
sellawillai	s e l l a w i l l ai 
soosiyal	s oo s i y a l 
idarxkaana	i d a rx k aa n a 
paarkkaadee	p aa r k k aa d ee 
taraadaram	t a r aa d a r a m 
kidxakkum	k i dx a k k u m 
talaiyil	t a l ai y i l 
wirainddeu	w i r ai nd d eu 
seywadeu	s e y w a d eu 
kurxippidxappadxeukirxadeu	k u rx i p p i dx a p p a dx eu k i rx a d eu 
aanggilam	aa ng g i l a m 
munddaiya	m u nd d ai y a 
pootxtxeut	p oo tx tx eu t 
patxrxiyadeu	p a tx rx i y a d eu 
wasitteu	w a s i t t eu 
malxigaikkadxai	m a lx i g ai k k a dx ai 
skeen	s k ee n 
pidxiccireukkeu	p i dx i c c i r eu k k eu 
ndambar	nd a m b a r 
uur	uu r 
pakkam	p a k k a m 
tara	t a r a 
talaindagaram	t a l ai nd a g a r a m 
peetx	p ee tx 
idarxkeu	i d a rx k eu 
warrxeen	w a r rx ee n 
muyarxsiyai	m u y a rx s i y ai 
parisoodanai	p a r i s oo d a n ai 
tiirweukkaana	t ii r w eu k k aa n a 
yaareukkum	y aa r eu k k u m 
tuukkik	t uu k k i k 
fiiwar	f ii w a r 
eksaam	e k s aa m 
aarambikkudeu	aa r a m b i k k u d eu 
kalyaanxam	k a l y aa nx a m 
amaanusxiyam	a m aa n u sx i y a m 
ndaaleu	nd aa l eu 
arasan	a r a s a n 
seewai	s ee w ai 
kaanxappadxeukinrxana	k aa nx a p p a dx eu k i n rx a n a 
waariyaana	w aa r i y aa n a 
penxgalxeukkeu	p e nx g a lx eu k k eu 
ndamba	nd a m b a 
kazhuwiya	k a zh u w i y a 
kinxdxal	k i nx dx a l 
kuuwalil	k uu w a l i l 
suuriyan	s uu r i y a n 
murxpagal	m u rx p a g a l 
aadxaiyil	aa dx ai y i l 
pannaatxtxalxawilum	p a n n aa tx tx a lx a w i l u m 
tidxiir	t i dx ii r 
paarunggalx	p aa r u ng g a lx 
kuudxaadeu	k uu dx aa d eu 
kodxeukkappatxtxadeu	k o dx eu k k a p p a tx tx a d eu 
kalaaccaara	k a l aa c c aa r a 
amudamum	a m u d a m u m 
ndilaiyil	nd i l ai y i l 
aayweu	aa y w eu 
kaalattilum	k aa l a t t i l u m 
etiraana	e t i r aa n a 
kuudxiyawaiyaa	k uu dx i y a w ai y aa 
txeestxaa	tx ee s tx aa 
pootxtxaareu	p oo tx tx aa r eu 
peer	p ee r 
petxtxiyai	p e tx tx i y ai 
marxadi	m a rx a d i 
mariyaadai	m a r i y aa d ai 
manddirap	m a nd d i r a p 
aasaippatxtxaar	aa s ai p p a tx tx aa r 
inspireesxan	i n s p i r ee sx a n 
awarai	a w a r ai 
appadxit	a p p a dx i t 
um	u m 
jeyanddi	j e y a nd d i 
wilxaiyum	w i lx ai y u m 
padxuwaan	p a dx u w aa n 
sirxappittanar	s i rx a p p i t t a n a r 
kuzhanddai	k u zh a nd d ai 
amaiccarawai	a m ai c c a r a w ai 
eetxtxalxawil	ee tx tx a lx a w i l 
piradeesattirxkeu	p i r a d ee s a t t i rx k eu 
ndirxaiweetxrxappatxtxa	nd i rx ai w ee tx rx a p p a tx tx a 
talaiwargalx	t a l ai w a r g a lx 
tuudai	t uu d ai 
saappitxtxeen	s aa p p i tx tx ee n 
pirippar	p i r i p p a r 
waraikkum	w a r ai k k u m 
magizhcciyaagap	m a g i zh c c i y aa g a p 
itupoonrxa	i t u p oo n rx a 
seytikkurxippeu	s e y t i k k u rx i p p eu 
awatxrxil	a w a tx rx i l 
keaadxutteu	k e aa dx u t t eu 
inippeu	i n i p p eu 
dxaaktxar	dx aa k tx a r 
amaraadee	a m a r aa d ee 
enggalx	e ng g a lx 
wisxam	w i sx a m 
konxdxirunddaan	k o nx dx i r u nd d aa n 
wagittawar	w a g i t t a w a r 
toolwikkeu	t oo l w i k k eu 
kiraama	k i r aa m a 
ulxiyin	u lx i y i n 
ippagudigalxil	i p p a g u d i g a lx i l 
waruwa	w a r u w a 
buwaneesxwar	b u w a n ee sx w a r 
punidam	p u n i d a m 
awarudxaiya	a w a r u dx ai y a 
kolxlxawum	k o lx lx a w u m 
suwarkkanggalxil	s u w a r k k a ng g a lx i l 
migapperiya	m i g a p p e r i y a 
eerxpadxuttiya	ee rx p a dx u t t i y a 
payanpadxutta	p a y a n p a dx u t t a 
ndirxuwananggalx	nd i rx u w a n a ng g a lx 
padiwaagiyulxlxadeu	p a d i w aa g i y u lx lx a d eu 
appaa	a p p aa 
siltxrans	s i l tx r a n s 
janawari	j a n a w a r i 
kolx	k o lx 
purxaa	p u rx aa 
tawam	t a w a m 
oruwagai	o r u w a g ai 
tadxai	t a dx ai 
paarwai	p aa r w ai 
paakka	p aa k k a 
kaalellaam	k aa l e l l aa m 
keek	k ee k 
kiriidxam	k i r ii dx a m 
kadai	k a d ai 
seyya	s e y y a 
teerweu	t ee r w eu 
kanxeesxkuriyil	k a nx ee sx k u r i y i l 
porundaik	p o r u nd ai k 
wiinxum	w ii nx u m 
ndiyuu	nd i y uu 
tuudeu	t uu d eu 
gunxamadxainddeu	g u nx a m a dx ai nd d eu 
padawiyil	p a d a w i y i l 
sutxrxulaa	s u tx rx u l aa 
waayppugalx	w aa y p p u g a lx 
petxrxulxlxana	p e tx rx u lx lx a n a 
taippuusat	t ai p p uu s a t 
tuunxdxeukirxadeu	t uu nx dx eu k i rx a d eu 
seytiyinaal	s e y t i y i n aa l 
txaark	tx aa r k 
adirasam	a d i r a s a m 
kaalai	k aa l ai 
eelakkaay	ee l a k k aa y 
edxutteu	e dx u t t eu 
maruttuwa	m a r u t t u w a 
kalandduraiyaadxiyireukkirxaar	k a l a nd d u r ai y aa dx i y i r eu k k i rx aa r 
pattirikkaiyaalxargalxidxam	p a t t i r i k k ai y aa lx a r g a lx i dx a m 
seyyappatxtxulxlxadeu	s e y y a p p a tx tx u lx lx a d eu 
mikka	m i k k a 
pakkattil	p a k k a t t i l 
sariyillaiyaa	s a r i y i l l ai y aa 
utxkaareu	u tx k aa r eu 
suuzhal	s uu zh a l 
kaasxmiir	k aa sx m ii r 
appaal	a p p aa l 
karxai	k a rx ai 
urxcawattai	u rx c a w a t t ai 
jaakkiradaiyaaga	j aa k k i r a d ai y aa g a 
irunddadai	i r u nd d a d ai 
suuppuwadeu	s uu p p u w a d eu 
kuwakaatti	k u w a k aa t t i 
warai	w a r ai 
innikkeu	i n n i k k eu 
kariim	k a r ii m 
winaadxigalxeukkum	w i n aa dx i g a lx eu k k u m 
pirxakeu	p i rx a k eu 
katxtxitxtxeen	k a tx tx i tx tx ee n 
warumpoodeu	w a r u m p oo d eu 
paatruum	p aa t r uu m 
kuurxeu	k uu rx eu 
inikkum	i n i k k u m 
kanxini	k a nx i n i 
adxuppil	a dx u p p i l 
ndiinggalx	nd ii ng g a lx 
mugappuppakkattil	m u g a p p u p p a k k a t t i l 
wairalaagi	w ai r a l aa g i 
ilxaiyaraajaa	i lx ai y a r aa j aa 
maanaamadurai	m aa n aa m a d u r ai 
katteukkodxeukkirxadudaan	k a t t eu k k o dx eu k k i rx a d u d aa n 
panxnxitxtxeen	p a nx nx i tx tx ee n 
irunddaan	i r u nd d aa n 
suudxaamanxi	s uu dx aa m a nx i 
tadxaagam	t a dx aa g a m 
waazhwee	w aa zh w ee 
panxam	p a nx a m 
andda	a nd d a 
maruttuwargalxee	m a r u t t u w a r g a lx ee 
wanxanggubawargalx	w a nx a ng g u b a w a r g a lx 
edxeukka	e dx eu k k a 
ruum	r uu m 
eppozhudum	e p p o zh u d u m 
taay	t aa y 
kaatxrxulxlxa	k aa tx rx u lx lx a 
kasakkik	k a s a k k i k 
paadugaakkappadxa	p aa d u g aa k k a p p a dx a 
pagudiyil	p a g u d i y i l 
ndadxanddupookirxaar	nd a dx a nd d u p oo k i rx aa r 
katxtxurai	k a tx tx u r ai 
padxikka	p a dx i k k a 
warawillai	w a r a w i l l ai 
wilxaiyaadxinar	w i lx ai y aa dx i n a r 
emadeu	e m a d eu 
ireukkaanggalxaa	i r eu k k aa ng g a lx aa 
paareu	p aa r eu 
puurwa	p uu r w a 
eenddinaan	ee nd d i n aa n 
kanx	k a nx 
uukkamee	uu k k a m ee 
iraanxuwa	i r aa nx u w a 
tirumbinar	t i r u m b i n a r 
ndaanggalxum	nd aa ng g a lx u m 
stxaar	s tx aa r 
seyyappatxtxa	s e y y a p p a tx tx a 
ndambeukirxoom	nd a m b eu k i rx oo m 
muppatti	m u p p a t t i 
otxtxeuk	o tx tx eu k 
iiyam	ii y a m 
ndaagam	nd aa g a m 
uurwadeu	uu r w a d eu 
tiiraakkoobam	t ii r aa k k oo b a m 
payanpadxuttaginrxanar	p a y a n p a dx u t t a g i n rx a n a r 
peeccuwaarttai	p ee c c u w aa r t t ai 
panxattai	p a nx a t t ai 
kolxkinrxanar	k o lx k i n rx a n a r 
latxcattai	l a tx c a t t ai 
uyirkgalxilum	u y i r g a lx i l u m 
pootxtxaaraa	p oo tx tx aa r aa 
jaalraa	j aa l r aa 
pazhanggudxi	p a zh a ng g u dx i 
ozhunggeu	o zh u ng g eu 
adilirundda	a d i l i r u nd d a 
kuuliyai	k uu l i y ai 
kuurxiyiruppadaawadeu	k uu rx i y i r u p p a d aa w a d eu 
enx	e nx 
inxaiyattalxa	i nx ai y a t t a lx a 
suupparaa	s uu p p a r aa 
toonrxuga	t oo n rx u g a 
yaadum	y aa d u m 
elximaiyaay	e lx i m ai y aa y 
sxaajagaan	sx aa j a g aa n 
suurxaawalxiyinaal	s uu rx aa w a lx i y i n aa l 
mozhigalx	m o zh i g a lx 
mattiya	m a t t i y a 
txawar	tx a w a r 
ndanniiril	nd a n n ii r i l 
edxutteukkolxlxum	e dx u t t eu k k o lx lx u m 
seerkkaikkaana	s ee r k k ai k k aa n a 
peyargalx	p e y a r g a lx 
walikkudeu	w a l i k k u d eu 
paartteu	p aa r t t eu 
koosxam	k oo sx a m 
yaawarum	y aa w a r u m 
karuwigalx	k a r u w i g a lx 
pidxikkumaa	p i dx i k k u m aa 
sariyaana	s a r i y aa n a 
pagal	p a g a l 
izhuppadeu	i zh u p p a d eu 
weenxdxumenak	w ee nx dx u m e n a k 
tinam	t i n a m 
porulxee	p o r u lx ee 
wazhikaatxtxeukirxapadxi	w a zh i k aa tx tx eu k i rx a p a dx i 
tolai	t o l ai 
sutxrxeu	s u tx rx eu 
suraikkaay	s u r ai k k aa y 
muzhanggeu	m u zh a ng g eu 
sanggee	s a ng g ee 
mudalil	m u d a l i l 
ozhippeu	o zh i p p eu 
dxaalareukkeu	dx aa l a r eu k k eu 
eeraalxamaana	ee r aa lx a m aa n a 
murxeukkeu	m u rx eu k k eu 
teeytteuk	t ee y t t eu k 
walxaiyam	w a lx ai y a m 
txiyaakoo	tx i y aa k oo 
padxeukolai	p a dx eu k o l ai 
laitx	l ai tx 
pakkattula	p a k k a t t u l a 
haasanam	h aa s a n a m 
pootxtxaalum	p oo tx tx aa l u m 
perxeu	p e rx eu 
awatxrxai	a w a tx rx ai 
eerxkanawee	ee rx k a n a w ee 
inrxeu	i n rx eu 
kazhuwi	k a zh u w i 
ulxlxaar	u lx lx aa r 
wibattil	w i b a t t i l 
ezheukirxadeu	e zh eu k i rx a d eu 
umpulxlxaiya	u m p u lx lx ai y a 
ireukkirxaar	i r eu k k i rx aa r 
silawatxrxai	s i l a w a tx rx ai 
uusi	uu s i 
enkitxtxa	e n k i tx tx a 
pozhudeu	p o zh u d eu 
iiwadeu	ii w a d eu 
yaanai	y aa n ai 
sirxiya	s i rx i y a 
irundduwarum	i r u nd d u w a r u m 
mudal	m u d a l 
kalappadxam	k a l a p p a dx a m 
piriyaanxiyum	p i r i y aa nx i y u m 
setx	s e tx 
ainduurxeu	ai nd uu rx eu 
tunxi	t u nx i 
tariyaa	t a r i y aa 
jaalam	j aa l a m 
udxaleukkeu	u dx a l eu k k eu 
mayil	m a y i l 
tiruppallaanxdxeu	t i r u p p a l l aa nx dx eu 
kaappikkotxtxaigalxaaga	k aa p p i k k o tx tx ai g a lx aa g a 
kalandda	k a l a nd d a 
adxipanxiyawillai	a dx i p a nx i y a w i l l ai 
pookkuwaratteu	p oo k k u w a r a t t eu 
ndunxnxiir	nd u nx nx ii r 
munnitxtxeu	m u n n i tx tx eu 
patxtxiniyoodxeu	p a tx tx i n i y oo dx eu 
porulxgalxai	p o r u lx g a lx ai 
uurladaan	uu r l a d aa n 
uulxaiyidxum	uu lx ai y i dx u m 
kal	k a l 
takka	t a k k a 
awargalxeukkeu	a w a r g a lx eu k k eu 
wiwarikkirxadeu	w i w a r i k k i rx a d eu 
appagudigalxil	a p p a g u d i g a lx i l 
mugilgalxum	m u g i l g a lx u m 
pudeu	p u d eu 
keetxtxeuk	k ee tx tx eu k 
porulxeukkeu	p o r u lx eu k k eu 
rasigargalxeukkeu	r a s i g a r g a lx eu k k eu 
enak	e n a k 
waazhkkai	w aa zh k k ai 
mudxiccaacceu	m u dx i c c aa c c eu 
unkitxtxa	u n k i tx tx a 
keeratx	k ee r a tx 
enrxaal	e n rx aa l 
saambal	s aa m b a l 
pool	p oo l 
raamar	r aa m a r 
senggadir	s e ng g a d i r 
pagai	p a g ai 
sirxideu	s i rx i d eu 
pookum	p oo k u m 
etirpaarkkinrxeen	e t i r p aa r k k i n rx ee n 
dxelliyil	dx e l l i y i l 
wilaiyil	w i l ai y i l 
amara	a m a r a 
magizhcciyoodxeu	m a g i zh c c i y oo dx eu 
ponggal	p o ng g a l 
kuyil	k u y i l 
iteukurxitteu	i t eu k u rx i t t eu 
kudxumba	k u dx u m b a 
maatxrxattirxkulxlxaana	m aa tx rx a t t i rx k u lx lx aa n a 
kaayccaleukkeu	k aa y c c a l eu k k eu 
uttarawitxtxirunddadeu	u t t a r a w i tx tx i r u nd d a d eu 
mudxiyaadenrxeu	m u dx i y aa d e n rx eu 
patxrxaakkurxaiyaip	p a tx rx aa k k u rx ai y ai p 
peereu	p ee r eu 
ndaangga	nd aa ng g a 
ndambaadee	nd a m b aa d ee 
samiibamaaga	s a m ii b a m aa g a 
garjikkum	g a r j i k k u m 
tuutxrxikkolx	t uu tx rx i k k o lx 
wellam	w e l l a m 
kudxuwaiyaik	k u dx u w ai y ai k 
iruppeu	i r u p p eu 
padxattirxkaana	p a dx a t t i rx k aa n a 
ndiir	nd ii r 
dxawutx	dx a w u tx 
winjnjaana	w i nj nj aa n a 
daaniyam	d aa n i y a m 
kudxiyurimai	k u dx i y u r i m ai 
keelariyai	k ee l a r i y ai 
wasuul	w a s uu l 
ezhuppinaar	e zh u p p i n aa r 
pookacceyyalaam	p oo k a c c e y y a l aa m 
wiitxtxeukkulxlxa	w ii tx tx eu k k u lx lx a 
ndaa	nd aa 
sanggamam	s a ng g a m a m 
pilxirxum	p i lx i rx u m 
adirupti	a d i r u p t i 
migawum	m i g a w u m 
padilalxikka	p a d i l a lx i k k a 
paadugaappeu	p aa d u g aa p p eu 
oppeukkonxdxaar	o p p eu k k o nx dx aa r 
wetxtxi	w e tx tx i 
waramilxagaay	w a r a m i lx a g aa y 
padxanggalxilum	p a dx a ng g a lx i l u m 
muteukeu	m u t eu k eu 
ennoodxa	e n n oo dx a 
sutxtxuraip	s u tx tx u r ai p 
poorxa	p oo rx a 
manam	m a n a m 
panddai	p a nd d ai 
seyyappadxum	s e y y a p p a dx u m 
mazhaiyee	m a zh ai y ee 
todxar	t o dx a r 
ndidikkeu	nd i d i k k eu 
ellaarum	e l l aa r u m 
waliyurxuttinaar	w a l i y u rx u t t i n aa r 
kaalaiyila	k aa l ai y i l a 
dxres	dx r e s 
walikkum	w a l i k k u m 
suudxaa	s uu dx aa 
iiramaa	ii r a m aa 
pugai	p u g ai 
eerikkeu	ee r i k k eu 
padxippadeu	p a dx i p p a d eu 
maranxamum	m a r a nx a m u m 
wilxaiyaadxuwadillai	w i lx ai y aa dx u w a d i l l ai 
katxtxanxanggalx	k a tx tx a nx a ng g a lx 
terxkeu	t e rx k eu 
eerxpaadxugalx	ee rx p aa dx u g a lx 
igazhnddeu	i g a zh nd d eu 
awaree	a w a r ee 
ilxampenx	i lx a m p e nx 
kaanggiras	k aa ng g i r a s 
paambugalx	p aa m b u g a lx 
kutxrxawaalxi	k u tx rx a w aa lx i 
rees	r ee s 
injji	i nj j i 
taajmahaalai	t aa j m a h aa l ai 
enakkeu	e n a k k eu 
piramaanxdxa	p i r a m aa nx dx a 
roosxam	r oo sx a m 
manandilaiyaiyum	m a n a nd i l ai y ai y u m 
kaiyadxakka	k ai y a dx a k k a 
ilakkaaga	i l a k k aa g a 
samandilaiyil	s a m a nd i l ai y i l 
urimaiyaa	u r i m ai y aa 
warugirxaar	w a r u g i rx aa r 
tappeu	t a p p eu 
juulai	j uu l ai 
muulaiyil	m uu l ai y i l 
kaip	k ai p 
tinggalx	t i ng g a lx 
siikkirattil	s ii k k i r a t t i l 
wiirargalxeukkaana	w ii r a r g a lx eu k k aa n a 
magaranddam	m a g a r a nd d a m 
wiseesxam	w i s ee sx a m 
sidambaram	s i d a m b a r a m 
seydaal	s e y d aa l 
seydeu	s e y d eu 
onrxum	o n rx u m 
tiipaawalxi	t ii p aa w a lx i 
ndirxaiya	nd i rx ai y a 
penxgalxidxam	p e nx g a lx i dx a m 
wibatteu	w i b a t t eu 
sinddaiyai	s i nd d ai y ai 
karxiweeppilai	k a rx i w ee p p i l ai 
kuuppidxatxtxumaa	k uu p p i dx a tx tx u m aa 
sennaiyila	s e n n ai y i l a 
idxa	i dx a 
njaalam	nj aa l a m 
pazham	p a zh a m 
iyambeu	i y a m b eu 
kadxarxkaraiyil	k a dx a rx k a r ai y i l 
anddat	a nd d a t 
potumakkalxai	p o d u m a k k a lx ai 
wiinxaakka	w ii nx aa k k a 
weedxattil	w ee dx a t t i l 
tirumbinaar	t i r u m b i n aa r 
ulxlxaatxci	u lx lx aa tx c i 
arxikkaiyaik	a rx i k k ai y ai k 
karutteu	k a r u t t eu 
wagaiyil	w a g ai y i l 
teriwittanar	t e r i w i t t a n a r 
alxitta	a lx i t t a 
muudxanum	m uu dx a n u m 
kulxirudeu	k u lx i r u d eu 
puttagam	p u t t a g a m 
endda	e nd d a 
utweegattai	u t w ee g a t t ai 
ndadxittulxlxaar	nd a dx i t t u lx lx aa r 
seyda	s e y d a 
urxanggac	u rx a ng g a c 
stxaak	s tx aa k 
aidiigam	ai d ii g a m 
aajar	aa j a r 
bakti	b a k t i 
sittiramum	s i t t i r a m u m 
kawasam	k a w a s a m 
stambittadeu	s t a m b i t t a d eu 
inddiya	i nd d i y a 
irattam	i r a t t a m 
kaal	k aa l 
irundducceu	i r u nd d u c c eu 
wilxaiyaatxtxeu	w i lx ai y aa tx tx eu 
kaayamadxaindda	k aa y a m a dx ai nd d a 
unggalxaik	u ng g a lx ai k 
tamakkeu	t a m a k k eu 
dayaweu	d a y a w eu 
jenma	j e n m a 
toosxattirxkeu	t oo sx a t t i rx k eu 
toonxdxiyadeu	t oo nx dx i y a d eu 
ootxtxai	oo tx tx ai 
ndalamalxikkum	nd a l a m a lx i k k u m 
uurudxan	uu r u dx a n 
ilawasam	i l a w a s a m 
seydaan	s e y d aa n 
sambanddamaaga	s a m b a nd d a m aa g a 
azhittidxuwoom	a zh i t t i dx u w oo m 
iwargalx	i w a r g a lx 
wiral	w i r a l 
palweerxeu	p a l w ee rx eu 
udxambeu	u dx a m b eu 
fangsxan	f a ng sx a n 
dusxtxa	d u sx tx a 
ndadxigar	nd a dx i g a r 
aarxudal	aa rx u d a l 
ndails	nd ai l s 
kaatxtxa	k aa tx tx a 
katxtxam	k a tx tx a m 
kedxuwaan	k e dx u w aa n 
aayinum	aa y i n u m 
kulxir	k u lx i r 
mannaa	m a n n aa 
minnanxeu	m i n n a nx eu 
sanddarppasuuzhndilaigalxai	s a nd d a r p p a s uu zh nd i l ai g a lx ai 
teerwil	t ee r w i l 
panxiyai	p a nx i y ai 
wanddana	w a nd d a n a 
ndaadxaaga	nd aa dx aa g a 
wazhiyaaga	w a zh i y aa g a 
kadxunggoobam	k a dx u ng g oo b a m 
puumi	p uu m i 
dxisain	dx i s ai n 
paarkkumpoodeu	p aa r k k u m p oo d eu 
part	p a r t 
iwargalxait	i w a r g a lx ai t 
padxuttappatxtxawargalxaaga	p a dx u t t a p p a tx tx a w a r g a lx aa g a 
azhiweu	a zh i w eu 
tanadeu	t a n a d eu 
sirxaiyil	s i rx ai y i l 
poowaa	p oo w aa 
kiptx	k i p tx 
koowil	k oo w i l 
pooraay	p oo r aa y 
aayudam	aa y u d a m 
ilxainjan	i lx ai nj a n 
ndadxattappadxum	nd a dx a t t a p p a dx u m 
rool	r oo l 
perumalxawil	p e r u m a lx a w i l 
wiinxaagac	w ii nx aa g a c 
kooldxaa	k oo l dx aa 
kasaayam	k a s aa y a m 
poliwaaga	p o l i w aa g a 
patxtxam	p a tx tx a m 
alxanddeu	a lx a nd d eu 
adxakkeu	a dx a k k eu 
ndeerattil	nd ee r a t t i l 
maadattil	m aa d a t t i l 
munbeu	m u n b eu 
tunxdxugalxaaga	t u nx dx u g a lx aa g a 
ndanrxi	nd a n rx i 
seydadarxkaaga	s e y d a d a rx k aa g a 
pugaippadxam	p u g ai p p a dx a m 
oodxuna	oo dx u n a 
solli	s o l l i 
unxmaigalxai	u nx m ai g a lx ai 
waanoli	w aa n o l i 
ndadxawadxikkaigalxai	nd a dx a w a dx i k k ai g a lx ai 
kanddaga	k a nd d a g a 
ndalla	nd a l l a 
amsanggalx	a m s a ng g a lx 
sarppam	s a r p p a m 
taazha	t aa zh a 
iidxupatxtxeu	ii dx u p a tx tx eu 
ewwaarxeu	e w w aa rx eu 
payanpadxuttuwadait	p a y a n p a dx u t t u w a d ai t 
paadugaappum	p aa d u g aa p p u m 
amaidikkeu	a m ai d i k k eu 
ndirxka	nd i rx k a 
ennudxaiya	e n n u dx ai y a 
ndiikkappatxtxa	nd ii k k a p p a tx tx a 
pazhagaadee	p a zh a g aa d ee 
pugazhin	p u g a zh i n 
njaayirxeu	nj aa y i rx eu 
siwaneukkeu	s i w a n eu k k eu 
waazhnddaal	w aa zh nd d aa l 
enna	e n n a 
muulamaaga	m uu l a m aa g a 
mattiyastam	m a t t i y a s t a m 
waitteu	w ai t t eu 
padxattai	p a dx a t t ai 
taniyaaga	t a n i y aa g a 
satxtxamanrxam	s a tx tx a m a n rx a m 
tammaal	t a m m aa l 
waanggitxtxeu	w aa ng g i tx tx eu 
ndanjjeu	nd a nj j eu 
gunxam	g u nx a m 
maadulxai	m aa d u lx ai 
matxtxam	m a tx tx a m 
welxlxam	w e lx lx a m 
kuudxi	k uu dx i 
senddamizhum	s e nd d a m i zh u m 
jagattinai	j a g a t t i n ai 
mugattil	m u g a t t i l 
kaaseu	k aa s eu 
onrxudaan	o n rx u d aa n 
kulxirndda	k u lx i r nd d a 
udxanadxiyaana	u dx a n a dx i y aa n a 
sigiccaikkaaga	s i g i c c ai k k aa g a 
kidxaittulxlxana	k i dx ai t t u lx lx a n a 
kilxaas	k i lx aa s 
balasaali	b a l a s aa l i 
eerxpaadxeu	ee rx p aa dx eu 
konxdxeu	k o nx dx eu 
ndipunxargalxin	nd i p u nx a r g a lx i n 
teriwikkappatxtxulxlxadeu	t e r i w i k k a p p a tx tx u lx lx a d eu 
ituwee	i t u w ee 
seytireukkirxeen	s e y t i r eu k k i rx ee n 
ndadxippeu	nd a dx i p p eu 
kurxiyiidxugalx	k u rx i y ii dx u g a lx 
ndaadam	nd aa d a m 
kalanddeukonxdxeu	k a l a nd d eu k o nx dx eu 
kadiyena	k a d i y e n a 
wazhangga	w a zh a ng g a 
kalanddaayweu	k a l a nd d aa y w eu 
konxdxuwarappatxtxadeu	k o nx dx u w a r a p p a tx tx a d eu 
walxarcci	w a lx a r c c i 
aktxoobar	a k tx oo b a r 
saalaiyil	s aa l ai y i l 
seyyaadee	s e y y aa d ee 
padxar	p a dx a r 
miin	m ii n 
anaiwaradeu	a n ai w a r a d eu 
taaniyanggi	t aa n i y a ng g i 
awwaarxeu	a w w aa rx eu 
sirxeu	s i rx eu 
widxudi	w i dx u d i 
es	e s 
talxlxum	t a lx lx u m 
panxnxiyaa	p a nx nx i y aa 
wadxa	w a dx a 
kuurnddeu	k uu r nd d eu 
adxaadeu	a dx aa d eu 
minkalattin	m i n k a l a t t i n 
solween	s o l w ee n 
senrxirunddaan	s e n rx i r u nd d aa n 
sadi	s a d i 
kanxdxupidxippugalxai	k a nx dx u p i dx i p p u g a lx ai 
seyteukonxdxaan	s e y t eu k o nx dx aa n 
sinimaawil	s i n i m aa w i l 
ireukkeu	i r eu k k eu 
aansaraa	aa n s a r aa 
kaatxtxum	k aa tx tx u m 
karuttaranggam	k a r u t t a r a ng g a m 
satxrxeup	s a tx rx eu p 
tagawalgalxumee	t a g a w a l g a lx u m ee 
ezhutteut	e zh u t t eu t 
kaay	k aa y 
awa	a w a 
puucci	p uu c c i 
sanggeu	s a ng g eu 
taan	t aa n 
kadxikkum	k a dx i k k u m 
etirolikkinrxana	e t i r o l i k k i n rx a n a 
tanggalxadeu	t a ng g a lx a d eu 
sonnaalum	s o n n aa l u m 
saappitxtxiyaa	s aa p p i tx tx i y aa 
siikkaramaa	s ii k k a r a m aa 
ndooyatxrxa	nd oo y a tx rx a 
ndinaitteen	nd i n ai t t ee n 
arxiwiyal	a rx i w i y a l 
waazhkirxoom	w aa zh k i rx oo m 
wandda	w a nd d a 
ireukka	i r eu k k a 
maarudi	m aa r u d i 
waittanar	w ai t t a n a r 
appaakkeu	a p p aa k k eu 
kaatxtxeukirxaar	k aa tx tx eu k i rx aa r 
iniya	i n i y a 
kurxippitxtxa	k u rx i p p i tx tx a 
aduwum	a d u w u m 
widxamaatxtxaan	w i dx a m aa tx tx aa n 
patxtxaaseu	p a tx tx aa s eu 
muutxtxi	m uu tx tx i 
koolxgalx	k oo lx g a lx 
rambam	r a m b a m 
katxtxalxaikkeu	k a tx tx a lx ai k k eu 
seydanar	s e y d a n a r 
seyyum	s e y y u m 
anggattinaraal	a ng g a t t i n a r aa l 
keeptxan	k ee p tx a n 
hootxtxal	h oo tx tx a l 
aayitxucceu	aa y i tx u c c eu 
manjjalx	m a nj j a lx 
padxaadeu	p a dx aa d eu 
warxuttum	w a rx u t t u m 
seyalpatxtxadeu	s e y a l p a tx tx a d eu 
idxattileeyee	i dx a t t i l ee y ee 
ittitxtxattin	i t t i tx tx a t t i n 
eerxpatxuttappatxtxulxlxana	ee rx p a tx u t t a p p a tx tx u lx lx a n a 
kuzhanddaigalxeukkeu	k u zh a nd d ai g a lx eu k k eu 
idxattula	i dx a t t u l a 
panxnxatxtxumaa	p a nx nx a tx tx u m aa 
paappaa	p aa p p aa 
wadxakkeu	w a dx a k k eu 
adxakkamee	a dx a k k a m ee 
enbadeu	e n b a d eu 
muuzhkuwadupool	m uu zh k u w a d u p oo l 
kuurxiwitxtxeen	k uu rx i w i tx tx ee n 
arasiyal	a r a s i y a l 
ndilaippaadxeu	nd i l ai p p aa dx eu 
etuwum	e t u w u m 
marxuttaargalx	m a rx u t t aa r g a lx 
toolwiyutxrxadeu	t oo l w i y u tx rx a d eu 
ulxlxaatxcit	u lx lx aa tx c i t 
irunduurxeu	i r u nd uu rx eu 
piranxdxs	p i r a nx dx s 
wiitxtxil	w ii tx tx i l 
ooram	oo r a m 
widxuttireukkirxaar	w i dx u t t i r eu k k i rx aa r 
kurxippaaga	k u rx i p p aa g a 
adil	a d i l 
seyyawillai	s e y y a w i l l ai 
oosai	oo s ai 
siramamaanadalla	s i r a m a m aa n a d a l l a 
tanggac	t a ng g a c 
tiirmaananggalx	t ii r m aa n a ng g a lx 
munnaalx	m u n n aa lx 
potxtxal	p o tx tx a l 
poorxaangga	p oo rx aa ng g a 
njaabaga	nj aa b a g a 
suzhi	s u zh i 
teruwil	t e r u w i l 
parambarai	p a r a m b a r ai 
eerxpa	ee rx p a 
puunggaakkalxeukkeu	p uu ng g aa k k a lx eu k k eu 
wiidxiyoowaiyum	w ii dx i y oo w ai y u m 
pootxtxa	p oo tx tx a 
wanxdxi	w a nx dx i 
keedxeu	k ee dx eu 
maatxtxeukkeu	m aa tx tx eu k k eu 
padawigalxai	p a d a w i g a lx ai 
wiitxtxilum	w ii tx tx i l u m 
oruwareukkoruwar	o r u w a r eu k k o r u w a r 
talaiwirittaadxik	t a l ai w i r i t t aa dx i k 
sila	s i l a 
ndookkunggalx	nd oo k k u ng g a lx 
ndaanarxiween	nd aa n a rx i w ee n 
pizhaiyalla	p i zh ai y a l l a 
ndadxaipetxrxa	nd a dx ai p e tx rx a 
waa	w aa 
aa	aa 
eksaamkkeu	e k s aa m k k eu 
risxikkeu	r i sx i k k eu 
paanam	p aa n a m 
kurxai	k u rx ai 
katxtxumarattil	k a tx tx u m a r a t t i l 
idarxkaaga	i d a rx k aa g a 
enggeu	e ng g eu 
abisxeegam	a b i sx ee g a m 
wiirar	w ii r a r 
anuppappatxtxa	a n u p p a p p a tx tx a 
adanboodeu	a d a n b oo d eu 
dxeyli	dx e y l i 
kitxtxa	k i tx tx a 
onneu	o n n eu 
pon	p o n 
puujaiyil	p uu j ai y i l 
saasxtxaanggam	s aa sx tx aa ng g a m 
seywana	s e y w a n a 
kanxnxiyap	k a nx nx i y a p 
periya	p e r i y a 
orijinal	o r i j i n a l 
iruppadaal	i r u p p a d aa l 
mudxiyaadeu	m u dx i y aa d eu 
aanxgalxee	aa nx g a lx ee 
kadxugeu	k a dx u g eu 
irxaiyarulx	i rx ai y a r u lx 
tirumbiwarakkuudxumaa	t i r u m b i w a r a k k uu dx u m aa 
paadxam	p aa dx a m 
mudxiweukkeu	m u dx i w eu k k eu 
baadikkum	b aa d i k k u m 
seewalin	s ee w a l i n 
senggamalam	s e ng g a m a l a m 
paatxtxeup	p aa tx tx eu p 
uyirizhappeu	u y i r i zh a p p eu 
padxattil	p a dx a t t i l 
siiaawarisaip	s ii aa w a r i s ai p 
maandilamaaga	m aa nd i l a m aa g a 
tamizhagam	t a m i zh a g a m 
porxiyiyal	p o rx i y i y a l 
pookanxum	p oo k a nx u m 
dxiras	dx i r a s 
anggeu	a ng g eu 
aastireeliya	aa s t i r ee l i y a 
tayaarittireukkirxaar	t a y aa r i t t i r eu k k i rx aa r 
tarxpoodeu	t a rx p oo d eu 
romba	r o m b a 
warxutteuk	w a rx u t t eu k 
ippoo	i p p oo 
koolxaarxeu	k oo lx aa rx eu 
njaanam	nj aa n a m 
saarxeu	s aa rx eu 
tanddai	t a nd d ai 
bayam	b a y a m 
karxi	k a rx i 
minjjinaal	m i nj j i n aa l 
waazhttinaargalx	w aa zh t t i n aa r g a lx 
waal	w aa l 
petxrxeukkolxlxalaam	p e tx rx eu k k o lx lx a l aa m 
meukkiyat	m eu k k i y a t 
ndadxakkawillai	nd a dx a k k a w i l l ai 
ndaatxtxeukkeu	nd aa tx tx eu k k eu 
sanggili	s a ng g i l i 
penxgalx	p e nx g a lx 
ireukkeen	i r eu k k ee n 
aamaa	aa m aa 
tuulx	t uu lx 
wiwasaayigalx	w i w a s aa y i g a lx 
uruwaana	u r u w aa n a 
alladeu	a l l a d eu 
en	e n 
adxainddoor	a dx ai nd d oo r 
manandilaiyaip	m a n a nd i l ai y ai p 
wiidxiyoo	w ii dx i y oo 
pirabalam	p i r a b a l a m 
kiriim	k i r ii m 
sollidxuween	s o l l i dx u w ee n 
pootxtxi	p oo tx tx i 
ilxainjaneukkeu	i lx ai nj a n eu k k eu 
teriwikkinrxana	t e r i w i k k i n rx a n a 
aatxtxam	aa tx tx a m 
satxtxa	s a tx tx a 
idaiyadxutteu	i d ai y a dx u t t eu 
adilulxlxa	a d i l u lx lx a 
teriyawillai	t e r i y a w i l l ai 
ndilawiyadeu	nd i l a w i y a d eu 
weppam	w e p p a m 
adxanggiya	a dx a ng g i y a 
aatxtxattai	aa tx tx a t t ai 
iranxdxeu	i r a nx dx eu 
matxtxumtaan	m a tx tx u m t aa n 
seukkunduurxaaga	s eu k k u nd uu rx aa g a 
arxinddeu	a rx i nd d eu 
kurxaiwaaga	k u rx ai w aa g a 
arxiwiirgalxoo	a rx i w ii r g a lx oo 
kalyaanxatteukkeu	k a l y aa nx a t t eu k k eu 
usxnxam	u sx nx a m 
abaraadam	a b a r aa d a m 
kulam	k u l a m 
keetxtxaan	k ee tx tx aa n 
padilalxippiirgalx	p a d i l a lx i p p ii r g a lx 
hoormoon	h oo r m oo n 
puttam	p u t t a m 
eerxpaadxellaam	ee rx p aa dx e l l aa m 
skuulla	s k uu l l a 
dxiraskalar	dx i r a s k a l a r 
paattirattil	p aa t t i r a t t i l 
sanddaigalxeukkum	s a nd d ai g a lx eu k k u m 
ilawasamaaga	i l a w a s a m aa g a 
kanxdxaar	k a nx dx aa r 
aduwarai	a d u w a r ai 
eppozhudumee	e p p o zh u t u m ee 
alxikka	a lx i k k a 
karektxaana	k a r e k tx aa n a 
paartxtxisipeetx	p aa r tx tx i s i p ee tx 
padxikkirxeen	p a dx i k k i rx ee n 
meembaatxtxeut	m ee m b aa tx tx eu t 
idaippoonrxa	i d ai p p oo n rx a 
poonrxa	p oo n rx a 
tooni	t oo n i 
meelee	m ee l ee 
katxtxi	k a tx tx i 
parigaaram	p a r i g aa r a m 
tatruubamaaga	t a t r uu b a m aa g a 
suwai	s u w ai 
ayalndaadxugalxeukkeup	a y a l nd aa dx u g a lx eu k k eu p 
wagaigalx	w a g ai g a lx 
ndadxikkawulxlxadaagawum	nd a dx i k k a w u lx lx a d aa g a w u m 
suuppar	s uu p p a r 
paraparappaaga	p a r a p a r a p p aa g a 
tanxnxii	t a nx nx ii 
tanxnxiir	t a nx nx ii r 
tuuwi	t uu w i 
ndaay	nd aa y 
madippenx	m a d i p p e nx 
pagalawan	p a g a l a w a n 
wirxkappadxeukirxadeu	w i rx k a p p a dx eu k i rx a d eu 
eerxpadxeukirxadeu	ee rx p a dx eu k i rx a d eu 
wasanam	w a s a n a m 
ndadxaiperxa	nd a dx ai p e rx a 
kaatxtxamaaga	k aa tx tx a m aa g a 
waadaadxinaar	w aa d aa dx i n aa r 
toolwi	t oo l w i 
pazhaniyammaalx	p a zh a n i y a m m aa lx 
tiruwizhaaweukkeu	t i r u w i zh aa w eu k k eu 
kazhicceu	k a zh i c c eu 
irunggalx	i r u ng g a lx 
jeyhindd	j e y h i nd d 
peeseu	p ee s eu 
kaalaiyil	k aa l ai y i l 
rajini	r a j i n i 
taawaranggalxil	t aa w a r a ng g a lx i l 
ireukkaadeu	i r eu k k aa d eu 
seetxrxil	s ee tx rx i l 
sanxdxai	s a nx dx ai 
warala	w a r a l a 
panxnxi	p a nx nx i 
eenddeu	ee nd d eu 
danusxkoodxi	d a n u sx k oo dx i 
sotteu	s o t t eu 
manxikkeu	m a nx i k k eu 
kadxakkum	k a dx a k k u m 
adxeukkadxeukkaana	a dx eu k k a dx eu k k aa n a 
eetaawadeu	ee t aa w a d eu 
poolaweetaan	p oo l a w ee t aa n 
warrxaangga	w a r rx aa ng g a 
ndeeram	nd ee r a m 
maadam	m aa d a m 
tirxanddeu	t i rx a nd d eu 
kotxtxuwadeu	k o tx tx u w a d eu 
wisuwaasam	w i s u w aa s a m 
ndiidxikka	nd ii dx i k k a 
kidxanddaargalx	k i dx a nd d aa r g a lx 
inggee	i ng g ee 
orusinna	o r u s i n n a 
tinasari	t i n a s a r i 
pudxiccireukkaa	p u dx i c c i r eu k k aa 
leetx	l ee tx 
mahaawiir	m a h aa w ii r 
gooburam	g oo b u r a m 
puli	p u l i 
kidxaiccaa	k i dx ai c c aa 
awargalx	a w a r g a lx 
payanargalx	p a y a n a r g a lx 
rasigargalx	r a s i g a r g a lx 
wazhimaarxi	w a zh i m aa rx i 
raajaawaaga	r aa j aa w aa g a 
rajinikaanddeukkeu	r a j i n i k aa nd d eu k k eu 
poosxaakkaana	p oo sx aa k k aa n a 
porulx	p o r u lx 
waaynddadeu	w aa y nd d a d eu 
urai	u r ai 
seyti	s e y t i 
ippa	i p p a 
sappaatti	s a p p aa t t i 
weyitx	w e y i tx 
waangginiyaa	w aa ng g i n i y aa 
eerxi	ee rx i 
warugai	w a r u g ai 
kitxtxawanddaal	k i tx tx a w a nd d aa l 
agawum	a g a w u m 
karutteukkalx	k a r u t t eu k k a lx 
pirenjjeu	p i r e nj j eu 
adigamaaga	a d i g a m aa g a 
munnarum	m u n n a r u m 
sinddanaigalxai	s i nd d a n ai g a lx ai 
tirumanxap	t i r u m a nx a p 
idaip	i d ai p 
muunxeu	m uu nx eu 
awangga	a w a ng g a 
pambaram	p a m b a r a m 
pirxar	p i rx a r 
tirumbiwanddeu	t i r u m b i w a nd d eu 
maaseuk	m aa s eu k 
eksaameukkeu	e k s aa m eu k k eu 
win	w i n 
unxaweu	u nx a w eu 
katxtxeu	k a tx tx eu 
azhaippeu	a zh ai p p eu 
tarxkolai	t a rx k o l ai 
magan	m a g a n 
katx	k a tx 
muuladanam	m uu l a d a n a m 
elumbeu	e l u m b eu 
pinpatxrxeu	p i n p a tx rx eu 
tulakka	t u l a k k a 
ndinrxeu	nd i n rx eu 
wetxrxi	w e tx rx i 
idee	i d ee 
wanddaargalx	w a nd d aa r g a lx 
anaittaiyum	a n ai t t ai y u m 
kaaramaa	k aa r a m aa 
kilxambeu	k i lx a m b eu 
puliyaip	p u l i y ai p 
ozheukkamaaga	o zh eu k k a m aa g a 
katxrxeuk	k a tx rx eu k 
alxaweeyillai	a lx a w ee y i l l ai 
seyyappatxtxulxlxana	s e y y a p p a tx tx u lx lx a n a 
wareen	w a r ee n 
ennallaam	e n n a l l aa m 
welxiyila	w e lx i y i l a 
ezhuppaadee	e zh u p p aa d ee 
paambeu	p aa m b eu 
kattiyait	k a t t i y ai t 
weenxdxiya	w ee nx dx i y a 
mudxiyaamal	m u dx i y aa m a l 
wariyaa	w a r i y aa 
awalxeukkeu	a w a lx eu k k eu 
tuukkam	t uu k k a m 
miinawanin	m ii n a w a n i n 
kanxdxupidxikkappatxtxadeu	k a nx dx u p i dx i k k a p p a tx tx a d eu 
ndaadxugalxulx	nd aa dx u g a lx u lx 
widxudigalx	w i dx u d i g a lx 
weenxdxiyirunddadeu	w ee nx dx i y i r u nd d a d eu 
katxtxeukkaawal	k a tx tx eu k k aa w a l 
weerxillai	w ee rx i l l ai 
aaranjjeu	aa r a nj j eu 
malaiyaalxa	m a l ai y aa lx a 
gawanam	g a w a n a m 
etarxkaaga	e t a rx k aa g a 
waazhtteukalx	w aa zh t t eu k a lx 
aananddam	aa n a nd d a m 
ndii	nd ii 
aarxeu	aa rx eu 
ingga	i ng g a 
mutxtxaalx	m u tx tx aa lx 
wenggaayattaip	w e ng g aa y a t t ai p 
txaatxaa	tx aa tx aa 
matxrxapadxi	m a tx rx a p a dx i 
waagananggalx	w aa g a n a ng g a lx 
pirxandda	p i rx a nd d a 
welxiyitxtxa	w e lx i y i tx tx a 
maadiriyaaga	m aa d i r i y aa g a 
ulagin	u l a g i n 
uyaree	u y a r ee 
ndalladeu	nd a l l a d eu 
weenxumaa	w ee nx u m aa 
banggalxaadeesx	b a ng g a lx aa d ee sx 
siikkiram	s ii k k i r a m 
satxtxam	s a tx tx a m 
ndanrxum	nd a n rx u m 
taruween	t a r u w ee n 
seyyat	s e y y a t 
ulxlxa	u lx lx a 
inddiyaa	i nd d i y aa 
karuwuula	k a r u w uu l a 
wirxpanai	w i rx p a n ai 
kasxtxamum	k a sx tx a m u m 
adxippadxai	a dx i p p a dx ai 
appaayinmenxtx	a p p aa y i n m e nx tx 
panxnxanum	p a nx nx a n u m 
paambai	p aa m b ai 
saami	s aa m i 
payirxeu	p a y i rx eu 
insol	i n s o l 
anddappurattirxkuc	a nd d a p p u r a t t i rx k u c 
wilagi	w i l a g i 
waralai	w a r a l ai 
uleukkinaalx	u l eu k k i n aa lx 
iisiyaa	ii s i y aa 
kutxtxaiyil	k u tx tx ai y i l 
udxaimai	u dx ai m ai 
kazhitteuk	k a zh i t t eu k 
idanaiyadxutteu	i d a n ai y a dx u t t eu 
puunxdxeu	p uu nx dx eu 
tiiwaitteu	t ii w ai t t eu 
tozhilndutxpatturxai	t o zh i l nd u tx p a t t u rx ai 
aarambikkum	aa r a m b i k k u m 
hoom	h oo m 
marattai	m a r a t t ai 
paanxiyil	p aa nx i y i l 
adxiyaargalx	a dx i y aa r g a lx 
kaapi	k aa p i 
awarpaal	a w a r p aa l 
winxnxappa	w i nx nx a p p a 
ndal	nd a l 
kodxeukkumaarxeu	k o dx eu k k u m aa rx eu 
kuutxtxanxiyil	k uu tx tx a nx i y i l 
wiirargalxeukkeu	w ii r a r g a lx eu k k eu 
deesiya	d ee s i y a 
kucci	k u c c i 
panxdxam	p a nx dx a m 
kurxaiwatxrxa	k u rx ai w a tx rx a 
kawalaiyillaamal	k a w a l ai y i l l aa m a l 
atxikkatxi	a dx i k k a dx i 
tiruttam	t i r u t t a m 
awwappoodeu	a w w a p p oo d eu 
anxiwaguppeu	a nx i w a g u p p eu 
meukkiyattuwam	m eu k k i y a t t u w a m 
kadxumaiyaana	k a dx u m ai y aa n a 
smook	s m oo k 
pil	p i l 
aardxar	aa r dx a r 
erxiwadeu	e rx i w a d eu 
tambi	t a m b i 
oree	o r ee 
anuppiyulxlxoom	a n u p p i y u lx lx oo m 
etirpaarkkappatxtxeen	e t i r p aa r k k a p p a tx tx ee n 
abaraadamaagac	a b a r aa d a m aa g a c 
sanddoosxattirxkeu	s a nd d oo sx a t t i rx k eu 
weerxeu	w ee rx eu 
keaalxlxa	k e aa lx lx a 
eksarsais	e k s a r s ai s 
siwa	s i w a 
todxaada	t o dx aa d a 
miitum	m ii t u m 
ndagar	nd a g a r 
ndaan	nd aa n 
udxanee	u dx a n ee 
mudxiweu	m u dx i w eu 
widxa	w i dx a 
pidxikkum	p i dx i k k u m 
pidxikkala	p i dx i k k a l a 
suulam	s uu l a m 
seyyaweenxdxum	s e y y a w ee nx dx u m 
ulxlxanar	u lx lx a n a r 
tisaiyai	t i s ai y ai 
weerxa	w ee rx a 
padxeukkai	p a dx eu k k ai 
tulxi	t u lx i 
kurxitta	k u rx i t t a 
tadxaigalxai	t a dx ai g a lx ai 
kodxeukka	k o dx eu k k a 
gunxdxin	g u nx dx i n 
nduutxrxaanxdxugalxeukkeu	nd uu tx rx aa nx dx u g a lx eu k k eu 
widxeukirxeen	w i dx eu k i rx ee n 
seyalpaadxugalx	s e y a l p aa dx u g a lx 
maariyamman	m aa r i y a m m a n 
perxawillaiyenrxeu	p e rx a w i l l ai y e n rx eu 
ndaalxla	nd aa lx l a 
waanggala	w aa ng g a l a 
ndadxakkudeu	nd a dx a k k u d eu 
aanadeu	aa n a d eu 
iisaana	ii s aa n a 
tirundda	t i r u nd d a 
urxudiyalxikkirxaar	u rx u d i y a lx i k k i rx aa r 
sellaatxrxalil	s e l l aa tx rx a l i l 
klxik	k lx i k 
ellaa	e l l aa 
txwiitxtxil	tx w ii tx tx i l 
ittagaiyoor	i t t a g ai y oo r 
uyirizhanddulxlxaar	u y i r i zh a nd d u lx lx aa r 
ewwalxaweu	e w w a lx a w eu 
panggeu	p a ng g eu 
weenxdxi	w ee nx dx i 
kuzhi	k u zh i 
suwaril	s u w a r i l 
todxeu	t o dx eu 
waruwadeu	w a r u w a d eu 
karai	k a r ai 
mutxtxap	m u tx tx a p 
teeykkap	t ee y k k a p 
anxi	a nx i 
karuwi	k a r u w i 
kadxaigalxla	k a dx ai g a lx l a 
maadiriyaik	m aa d i r i y ai k 
ndadxaiperxuwadeu	nd a dx ai p e rx u w a d eu 
padxinddireukkum	p a dx i nd d i r eu k k u m 
penxgalxai	p e nx g a lx ai 
kazhuwanxum	k a zh u w a nx u m 
widxaa	w i dx aa 
guruwai	g u r u w ai 
arunddeu	a r u nd d eu 
hanuman	h a n u m a n 
palli	p a l l i 
aasaiyaay	aa s ai y aa y 
aimpulan	ai m p u l a n 
enrxa	e n rx a 
patxtxanai	p a tx tx a n ai 
eerxpatxtxulxlxadeu	ee rx p a tx tx u lx lx a d eu 
waatxcap	w aa tx c a p 
kaanxamudxiyawillai	k aa nx a m u dx i y a w i l l ai 
kurxippitxtxulxlxaar	k u rx i p p i tx tx u lx lx aa r 
suutxcamam	s uu tx c a m a m 
ahimsai	a h i m s ai 
siisanil	s ii s a n i l 
ndorxunggi	nd o rx u ng g i 
samamaana	s a m a m aa n a 
kanrxeu	k a n rx eu 
maatxtxoom	m aa tx tx oo m 
poyyaanadeu	p o y y aa n a d eu 
teetxi	t ee dx i 
piraccinai	p i r a c c i n ai 
ireukkideu	i r eu k k i d eu 
munnaadxi	m u n n aa dx i 
kulxikkanxum	k u lx i k k a nx u m 
uuttanxum	uu t t a nx u m 
wiitxtxula	w ii tx tx u l a 
weesxam	w ee sx a m 
nderuppil	nd e r u p p i l 
iruppeen	i r u p p ee n 
uudxagam	uu dx a g a m 
uuree	uu r ee 
waalx	w aa lx 
kawanittaan	k a w a n i t t aa n 
patxrxi	p a tx rx i 
kilxik	k i lx i k 
wilaiyinai	w i l ai y i n ai 
satxtxasabai	s a tx tx a s a b ai 
patrai	p a t r ai 
payanxigalx	p a y a nx i g a lx 
kalar	k a l a r 
poodxuween	p oo dx u w ee n 
puuseu	p uu s eu 
anggee	a ng g ee 
pappadxam	p a p p a dx a m 
iruppadeu	i r u p p a d eu 
tiimaiyaic	t ii m ai y ai c 
maadiri	m aa d i r i 
seydaar	s e y d aa r 
pootxtxoo	p oo tx tx oo 
kudxumbam	k u dx u m b a m 
ootxtxamudxiyaadeu	oo tx tx a m u dx i y aa d eu 
eerxpatxtxeu	ee rx p a tx tx eu 
seertteu	s ee r t t eu 
wekkam	w e k k a m 
suudxeu	s uu dx eu 
ozhittuwidxuwaar	o zh i t t u w i dx u w aa r 
udaweukirxadeu	u d a w eu k i rx a d eu 
perum	p e r u m 
attumiirxal	a t t u m ii rx a l 
karaiyaik	k a r ai y ai k 
adxaikkappatxtxaar	a dx ai k k a p p a tx tx aa r 
kaatxtxungga	k aa tx tx u ng g a 
pisiyaa	p i s i y aa 
kooppai	k oo p p ai 
teriwittulxlxadeu	t e r i w i t t u lx lx a d eu 
kadiriyakka	k a d i r i y a k k a 
pirxpagalil	p i rx p a g a l i l 
odeukkiidxeu	o d eu k k ii dx eu 
kaideu	k ai d eu 
baktiyoodxeu	b a k t i y oo dx eu 
adarxkeu	a d a rx k eu 
aaloosikkappatxtxadeu	aa l oo s i k k a p p a tx tx a d eu 
motta	m o t t a 
wazhakkin	w a zh a k k i n 
pugazh	p u g a zh 
wiizhcci	w ii zh c c i 
teriyaadeu	t e r i y aa d eu 
malaiyaalxam	m a l ai y aa lx a m 
kodxuttulxlxaar	k o dx u t t u lx lx aa r 
purinddeu	p u r i nd d eu 
puuriyum	p uu r i y u m 
ndeyil	nd e y i l 
mottamaa	m o t t a m aa 
tazhii	t a zh ii 
padxutteuk	p a dx u t t eu k 
ireukkattaan	i r eu k k a t t aa n 
kidxaikkudeu	k i dx ai k k u d eu 
ndagarppurxa	nd a g a r p p u rx a 
keelxwi	k ee lx w i 
paanxtxing	p aa nx tx i ng 
miidxiyaawil	m ii dx i y aa w i l 
panjjam	p a nj j a m 
padxi	p a dx i 
tawarxeu	t a w a rx eu 
sanddiran	s a nd d i r a n 
kurxitteu	k u rx i t t eu 
kuutxtxattil	k uu tx tx a t t i l 
weetanai	w ee t a n ai 
enbaar	e n b aa r 
paadxasaalaigalxil	p aa dx a s aa l ai g a lx i l 
payanpadxuttikkolxlxalaamee	p a y a n p a dx u t t i k k o lx lx a l aa m ee 
arxiwippeu	a rx i w i p p eu 
yaareu	y aa r eu 
ndel	nd e l 
ndaadxeu	nd aa dx eu 
oolaiccuwadxi	oo l ai c c u w a dx i 
seluttinar	s e l u t t i n a r 
padxanggalxeukkeu	p a dx a ng g a lx eu k k eu 
meelum	m ee l u m 
munaiyaagum	m u n ai y aa g u m 
aaywugalx	aa y w u g a lx 
kaaril	k aa r i l 
migaccirxandda	m i g a c c i rx a nd d a 
padxattait	p a dx a t t ai t 
agal	a g a l 
waruttamum	w a r u t t a m u m 
indda	i nd d a 
kaalanggalxil	k aa l a ng g a lx i l 
wagaigalxoo	w a g ai g a lx oo 
kooppeu	k oo p p eu 
wazhakkam	w a zh a k k a m 
solleu	s o l l eu 
staapanam	s t aa p a n a m 
ndiiril	nd ii r i l 
porxuppeetxrxeu	p o rx u p p ee tx rx eu 
murxaiyaagac	m u rx ai y aa g a c 
adigaari	a d i g aa r i 
wizhundditxtxirunddadeu	w i zh u nd d i tx tx i r u nd d a d eu 
aduwee	a d u w ee 
padxippeu	p a dx i p p eu 
etaaccum	e t aa c c u m 
annaikkeu	a n n ai k k eu 
kuuzh	k uu zh 
ikkaraikkeu	i k k a r ai k k eu 
aasaiyaik	aa s ai y ai k 
petxrxadeu	p e tx rx a d eu 
weenxdxaamee	w ee nx dx aa m ee 
welxiyee	w e lx i y ee 
ezhil	e zh i l 
walikkudu	w a l i k k u d u 
walikkala	w a l i k k a l a 
aansar	aa n s a r 
ndadxanddadeu	nd a dx a nd d a d eu 
pirxarai	p i rx a r ai 
widiyai	w i d i y ai 
kadxidam	k a dx i d a m 
tiitxtxaamee	t ii tx tx aa m ee 
pudxittaal	p u dx i t t aa l 
arximugam	a rx i m u g a m 
inxaiyadalxattil	i nx ai y a d a lx a t t i l 
ulxunddeu	u lx u nd d eu 
ais	ai s 
maadxiyila	m aa dx i y i l a 
puugambam	p uu g a m b a m 
suttamaaga	s u t t a m aa g a 
sanddaanam	s a nd d aa n a m 
ellaip	e l l ai p 
silar	s i l a r 
titxtxattin	t i tx tx a t t i n 
kadxai	k a dx ai 
widxungga	w i dx u ng g a 
kaalxi	k aa lx i 
kuranggeu	k u r a ng g eu 
pidxi	p i dx i 
tawira	t a w i r a 
payilwadait	p a y i l w a d ai t 
murxiweukkeuk	m u rx i w eu k k eu k 
paarttaar	p aa r t t aa r 
madippaanadeu	m a d i p p aa n a d eu 
aluwalargalx	a l u w a l a r g a lx 
wareukirxoom	w a r eu k i rx oo m 
peaaruttiyireukkinrxanar	p e aa r u t t i y i r eu k k i n rx a n a r 
konxdxulxlxaar	k o nx dx u lx lx aa r 
turxaigalxeukkeu	t u rx ai g a lx eu k k eu 
talaiya	t a l ai y a 
sollit	s o l l i t 
liiweu	l ii w eu 
kambeuk	k a m b eu k 
katti	k a t t i 
padakkam	p a d a k k a m 
miinxdxum	m ii nx dx u m 
kanxkaanxitteu	k a nx k aa nx i t t eu 
wazhakkuppadiweu	w a zh a k k u p p a d i w eu 
pariseu	p a r i s eu 
haaspitxal	h aa s p i tx a l 
fiiwaraa	f ii w a r aa 
pidxicceukkoo	p i dx i c c eu k k oo 
mannan	m a n n a n 
onbadeu	o n b a d eu 
meksikoo	m e k s i k oo 
kiloo	k i l oo 
keelxwigalxeukkeu	k ee lx w i g a lx eu k k eu 
todxarnddeu	t o dx a r nd d eu 
kadxandda	k a dx a nd d a 
ndiinggalxee	nd ii ng g a lx ee 
ulagileeyee	u l a g i l ee y ee 
patxtxiyal	p a tx tx i y a l 
ruubaay	r uu b aa y 
walikkudaa	w a l i k k u d aa 
waanggitxtxiyaa	w aa ng g i tx tx i y aa 
ndoonjjaanaaga	nd oo nj j aa n aa g a 
arxiyaamai	a rx i y aa m ai 
paadxik	p aa dx i k 
wiidxeu	w ii dx eu 
maruttuwamanaiyil	m a r u t t u w a m a n ai y i l 
iruppaargalx	i r u p p aa r g a lx 
adigam	a d i g a m 
moodxiyum	m oo dx i y u m 
pinwarum	p i n w a r u m 
pirxpagal	p i rx p a g a l 
ulxndaatxtxuc	u lx nd aa tx tx u c 
pala	p a l a 
ellaamee	e l l aa m ee 
ndabar	nd a b a r 
ladxaak	l a dx aa k 
weelaigalxum	w ee l ai g a lx u m 
kuutxtxaatxci	k uu tx tx aa tx c i 
enakkaaga	e n a k k aa g a 
ndiiyum	nd ii y u m 
pookalayaa	p oo k a l a y aa 
onrxee	o n rx ee 
seydawan	s e y d a w a n 
waitteuk	w ai t t eu k 
teriwittulxlxadaawadeu	t e r i w i t t u lx lx a d aa w a d eu 
kadxumaiyaaga	k a dx u m ai y aa g a 
wirumbeukirxoom	w i r u m b eu k i rx oo m 
ikkoowaikkeup	i k k oo w ai k k eu p 
kalwi	k a l w i 
uyarnddulxlxadeu	u y a r nd d u lx lx a d eu 
aantxani	aa n tx a n i 
pudiya	p u d i y a 
sawaalkalxaic	s a w aa l k a lx ai c 
dxepaasitx	dx e p aa s i tx 
iyalaada	i y a l aa d a 
awareukitxtxa	a w a r eu k i tx tx a 
muulam	m uu l a m 
illaiyeel	i l l ai y ee l 
adanai	a d a n ai 
rayilil	r a y i l i l 
duuram	d uu r a m 
kaagidam	k aa g i d a m 
ndanmai	nd a n m ai 
enrxaar	e n rx aa r 
poor	p oo r 
kuzhanddaigalx	k u zh a nd d ai g a lx 
kuutxtxamaa	k uu tx tx a m aa 
tolainjjeu	t o l ai nj j eu 
siirxum	s ii rx u m 
kalanddeu	k a l a nd d eu 
waippadaaga	w ai p p a d aa g a 
ulagalxawil	u l a g a lx a w i l 
wilxaiwikkak	w i lx ai w i k k a k 
waakkurxudiyai	w aa k k u rx u d i y ai 
kooyilin	k oo y i l i n 
tirumbik	t i r u m b i k 
suudxaakki	s uu dx aa k k i 
teewa	t ee w a 
pooliyaana	p oo l i y aa n a 
mai	m ai 
samaippadeu	s a m ai p p a d eu 
maargazhik	m aa r g a zh i k 
sinddikka	s i nd d i k k a 
tagawal	t a g a w a l 
seydaargalx	s e y d aa r g a lx 
tokudigalxil	t o k u d i g a lx i l 
solwadeu	s o l w a d eu 
sudxidaar	s u dx i d aa r 
kayirxeu	k a y i rx eu 
sagariyaa	s a g a r i y aa 
tawikkak	t a w i k k a k 
alxikkum	a lx i k k u m 
kirikketx	k i r i k k e tx 
watxtxaaram	w a tx tx aa r a m 
marxakka	m a rx a k k a 
pe	p e 
paarkkanxum	p aa r k k a nx u m 
kuuppitxtxeu	k uu p p i tx tx eu 
waazhtteu	w aa zh t t eu 
moodiram	m oo d i r a m 
kaalxai	k aa lx ai 
pullait	p u l l ai t 
meelaalxaraaga	m ee l aa lx a r aa g a 
murxai	m u rx ai 
uuzhiyam	uu zh i y a m 
wazhanggappatxtxana	w a zh a ng g a p p a tx tx a n a 
wadxakkuwadxakizhakkeu	w a dx a k k u w a dx a k i zh a k k eu 
tanmai	t a n m ai 
wiirargalx	w ii r a r g a lx 
anaitteuk	a n ai t t eu k 
engga	e ng g a 
sxanxmugak	sx a nx m u g a k 
anddac	a nd d a c 
kuurxappatxtxulxlxadeu	k uu rx a p p a tx tx u lx lx a d eu 
pooy	p oo y 
suutxkees	s uu tx k ee s 
uyir	u y i r 
kodxutta	k o dx u t t a 
saadaaranxa	s aa d aa r a nx a 
tiruppa	t i r u p p a 
ulxaweu	u lx a w eu 
pootxtxooweukkeu	p oo tx tx oo w eu k k eu 
warudaa	w a r u d aa 
panxiweu	p a nx i w eu 
buttiyait	b u t t i y ai t 
sirasil	s i r a s i l 
enddat	e nd d a t 
kulxiyal	k u lx i y a l 
txikketx	tx i k k e tx 
waangguna	w aa ng g u n a 
sxeemamaaga	sx ee m a m aa g a 
baasxai	b aa sx ai 
asxtxalaksxmi	a sx tx a l a k sx m i 
uzhai	u zh ai 
sudanddirap	s u d a nd d i r a p 
titxtxam	t i tx tx a m 
katxtxanggalxaaga	k a tx tx a ng g a lx aa g a 
tarawarisaip	t a r a w a r i s ai p 
isxtxam	i sx tx a m 
keelxir	k ee lx i r 
etiraaga	e t i r aa g a 
poodeu	p oo d eu 
sanitxaisar	s a n i tx ai s a r 
purusxan	p u r u sx a n 
kadxam	k a dx a m 
iiram	ii r a m 
taramaana	t a r a m aa n a 
toolai	t oo l ai 
sambawa	s a m b a w a 
meerxkonxdxeu	m ee rx k o nx dx eu 
warudeu	w a r u d eu 
sari	s a r i 
panxnxitxtxiyaa	p a nx nx i tx tx i y aa 
poodxalaamaa	p oo dx a l aa m aa 
pilleu	p i l l eu 
muga	m u g a 
panxbeu	p a nx b eu 
ndirambiyadeu	nd i r a m b i y a d eu 
mazhai	m a zh ai 
kurxi	k u rx i 
watxtxam	w a tx tx a m 
unggalxeukkeu	u ng g a lx eu k k eu 
enbadaagac	e n b a d aa g a c 
selutteukirxadeu	s e l u t t eu k i rx a d eu 
weelxaanxmai	w ee lx aa nx m ai 
sirxappeu	s i rx a p p eu 
murxaigalx	m u rx ai g a lx 
rikki	r i k k i 
ndey	nd e y 
isai	i s ai 
wareukinrxanar	w a r eu k i n rx a n a r 
raajjiyam	r aa j j i y a m 
adxaiyaar	a dx ai y aa r 
pozhudaik	p o zh u d ai k 
peeccaaga	p ee c c aa g a 
araseu	a r a s eu 
ndaanggalx	nd aa ng g a lx 
surakkappadxum	s u r a k k a p p a dx u m 
kanxippeu	k a nx i p p eu 
maadxal	m aa dx a l 
manxattakkaalxi	m a nx a t t a k k aa lx i 
arasaanggattudxan	a r a s aa ng g a t t u dx a n 
ndagarin	nd a g a r i n 
waaram	w aa r a m 
matxrxawargalxum	m a tx rx a w a r g a lx u m 
widxumurxai	w i dx u m u rx ai 
kulxi	k u lx i 
eenggum	ee ng g u m 
ndaanjjil	nd aa nj j i l 
wazhakkamaaga	w a zh a k k a m aa g a 
pootxtxiyidxa	p oo tx tx i y i dx a 
kaanxappadxeukirxadeu	k aa nx a p p a dx eu k i rx a d eu 
awarum	a w a r u m 
wiwaranggalx	w i w a r a ng g a lx 
sirxandda	s i rx a nd d a 
keaalxlxum	k e aa lx lx u m 
baarada	b aa r a d a 
adxaiyaada	a dx ai y aa d a 
warxanxdxa	w a rx a nx dx a 
dxisainla	dx i s ai n l a 
banddam	b a nd d a m 
sirxuwan	s i rx u w a n 
sakkaram	s a k k a r a m 
siiriyalgalx	s ii r i y a l g a lx 
payanpadxuttum	p a y a n p a dx u t t u m 
keetxtxaar	k ee tx tx aa r 
pagudiyileeyee	p a g u d i y i l ee y ee 
azhittuwidxum	a zh i t t u w i dx u m 
iiwining	ii w i n i ng 
wiik	w ii k 
uuril	uu r i l 
oosoonai	oo s oo n ai 
singgam	s i ng g a m 
kani	k a n i 
tudi	t u d i 
meel	m ee l 
teriyawanddulxlxadeu	t e r i y a w a nd d u lx lx a d eu 
parxaisaatxrxum	p a rx ai s aa tx rx u m 
alxawaana	a lx a w aa n a 
palappadxuttappatxtxirunddadeu	p a l a p p a dx u t t a p p a tx tx i r u nd d a d eu 
anxeu	a nx eu 
muunrxaawadeu	m uu n rx aa w a d eu 
amaiccagattai	a m ai c c a g a t t ai 
waasx	w aa sx 
raagi	r aa g i 
suwaiyaanadeu	s u w ai y aa n a d eu 
enxnxey	e nx nx e y 
igazhaadee	i g a zh aa d ee 
maats	m aa t s 
uutanum	uu t a n u m 
akka	a k k a
sil	sil 
!SIL	sil 
